::GetPrivateProfileSection	rrbmebmmmmmebmmmmmebmmmmme
::GetScriptManagerVariable	rrbmebmmmmebmmmmmebmmmmmme
::GetTokenAt	rrbmebmmmebe
::JS_DefineUCProperty	rrberbmmmmebmmmmmmmme
::SetMenuItemHierarchicalID	rrbmebmmebmmebmmmmmmmmmmebe
::SetResLoad	rrbmebmebmme
::fread	rrbmmme
AAS_Error	bmerbmmme
AAS_FreeAASLinkedEntities	bmerbmmebmmmmmmmebmmmmmme
ACMButton	bmmmmmmme
AF_DEFAULT_TRACK	berbmmmmmerbmmme
AND_EXP_AST__LINE_START	bmerbmerbmerrbmmerbmmme
APPCOMMAND_BROWSER_REFRESH	bmmmmmmmmerbmmmmmerbmmmmme
APR_FILEPATH_ENCODING_LOCALE	bmerbmmmmmmerbmmmmmmerbmmmme
APR_POLLSET_THREADSAFE	bmerbmmmmmerbmmmmmmmme
APR_WIN_CE_3	bmerbmerbers
APR_XML_ERROR_EXPAT	bmerbmerbmmmerbmmme
ARB_shader_objects_glUniform3fARB_pointer	bmerbmmmmerbmmmmmerbebmmmmmessbmerbmmmmme
ART_UTA_BBOX_Y0	bmerbmerbmmerss
ASTRewrite.TYPE	bmmmmmmmmerbmme
ASTView	bmmmmme
AST_CDR_DOCUMENTATION	bmerbmerbmmmmmmmmmmme
AST_FEATURE_DISCONNECT	bmerbmmmmmerbmmmmmmmme
AST_LOCK_FAILURE	bmerbmmerbmmmmme
AST_RTP_MAX	bmerbmerbme
ATK_ROLE_MENU	bmerbmmerbmme
AUTOMATIC_DATABASE_MEMORY_URL.equals	bmmmmmmmerbmmmmmmerbmmmmerbmerbmmmme
A_RFC931	srbmebme
ArrayToArrayInfoMap	bmmmebebmmmebmmebme
AtkCoordType	bmebmmmebmme
AtkTextIface	bmebmmebmmme
BARCODE_NO_ASCII	bmmmmmerberbmmme
BIT5_H	bmesrs
BOTLIB_AI_ALLOC_CHAT_STATE	bmmmmerberbmmmerbmmerbmmme
BSD_REGEX	bmerbmmme
BS_PUSHBUTTON	berbmmmmmmmme
BZipUncompress	bmmebmmmmmmmme
BaseExc	bmmebme
BlastBin2Csv	bmmmebmesbme
BlockRowPixels	bmmmebmebmmmme
BooleanECD	bmmmmmebme
BugBaseQuery.QUERY_UPDATE_BUGREPORTS	bmebmmebmmmerbmmmerbmmmmerbmmmmmmmme
BulletinConstants.TAGSTATUS	bmmmmmmebmmmmmmmerbmmmmmmme
CAInfo.SELFSIGNED	bmmmmerbmmmmmmmme
CBM_INIT	bmerbmme
CBuilderXProjectWriter	bmmmmmmebmmmmmmebmmmme
CCLASS_UPPER	bmmmmerbmmme
CDSC_PSADOBE	bmmerbmmmmme
CELLTYPE_BODY	bmmmmmmerbmme
CERT_DecodeCertificatePoliciesExtension	bmmerbmmmmebmmmmmmmmmebmmmmmmebmmmmmmme
CERT_SaveSMimeProfile	bmmerbmmebmmmebmmmmme
CFArrayCreateMutable	bmmmmmebmmmmebmmmmme
CFPAnalyser	bmmmmmmmmme
CFriendListCtrl	bmmmmmebmmebmme
CGConstants.MAX_CARDINALITY_COLOR	bmmmmmmmmmerbmerbmmmmmmmmmerbmmme
CHAR_DIAPRE_DECIMALE	bmmerbmmmmerbmmmmmme
CHECK_SERVICE_USE_OK	bmmmerbmmmmmerbmerbe
CHOICEHELP	bmmmmmmmme
CHROME_DIR_NAME	bmmmmerbmerbmme
CHU_ERR_ERROR	bmerbmerbmmme
CI_SIGNATURE	berbmmmmmmme
CKM_SHA384_HMAC	bmerbmebmerbmme
CK_C_INITIALIZE_ARGS	bersrbmmmmmmmmerbmme
CLASSTYPE_FRIEND_CLASSES	bmmmmmmmerbmmmmerbmmmmme
CLIENT_SSL	bmmmmerbme
CLIENT_THREADS_MIN	bmmmmerbmmmmmerbme
CLabelTab	bmmmmebme
CM_BoundBrush	berbmmmebmmme
CNumPad.FUNC_CLR	bmmebmerbmmerbme
CODE_null_unit_attr	bmmerbmmerbmmerbmme
COLLECTION_COMPLEX_TYPE_AST__PCOLLECTION_KEY	bmmmmmmmmerbmmmmmerbmmerbmerrbmmmmmmmmmerbme
COMPUTIME_FORMAT	bmmmmmmmerbmmmme
CONTINUE_PREV	bmmmmmmerbmme
CONV_OLD_CONVERT	bmmerbmerbmmmmme
CPU_features.i387	bmerbmmmmmmersbme
CRMF_CertReqMsgSetKeyEnciphermentPOP	bmmerbmmebmebmebmebmebmmmmmmmmmmebme
CSS_PROP_XUL	bmerbmmerbme
CSS_STATE_DELETED	bmerbmmmerbmmmmme
CSearchDlg	bmmmmmebme
CSimpleKnownFileArray	bmmmmmebmmmebmmebmmme
CStyleToken	bmmmmebmmme
CWColormap	bmmmmmmmme
CalcDiffInTotals	bmmebmmebebmmmme
CalcHorCornerOffset	bmmebmebmmmmebmmmme
Cam_MouseDown	bmerbmmmebmme
Cbcalc	bmmmme
CdlPackage.VARIABLE__SEMANTIC_ANNOTATIONS	bmebmmmmmerbmmmmmmerrbmmmmmmerbmmmmmmmmme
CharImpl	bmmebmme
ChildLocalHome.JNDI_NAME	bmmmebmmmebmmerbmmerbmme
ChildParentChooserWindow	bmmmebmmmmebmmmmmebmmmme
ChildrenHashOps	bmmmmmmebmmebme
ClassDescriptor.OOS_ARGS	bmmmebmmmmmmmmerbmerbmme
ClassType.ANNOTATION_TYPE_DECL	bmmmebmmerbmmmmmmmmerbmmerbmme
CommonMainRoutine	bmmmmebmmebmmmmme
ComponentBinderImplTest	bmmmmmmmebmmmmebmmebmme
ConfigParser.QUERY_CACHE_MAX_QUERIES	bmmmmebmmmmerbmmmerbmmmerbmerbmmmmme
Console_IO.str_emph	bmmmmmerberbmerbmme
Constants.ATTR_CLASS_VALUE_SOURCE	bmmmmmmmerbmmerbmmmerbmmmerbmmmme
Constants.FSWP	bmmmmmmmerbmme
Constants.JUNIT_DOUBLE_PRECISION	bmmmmmmmerbmmmerbmmmmerbmmmmmmme
Constants.amountOf	bmmmmmmmerbmmmmebe
ConstructAttributeTable	bmmmmmmmebmmmmmmmebmmme
CountRectProc	bmmmebmmebmme
Crawler.WEB	bmmmmmerbme
CreateImapManageMailAccountUrl	bmmmmebmmebmmmmebmmebmmmmmebme
CreateSVGTransform	bmmmmebmmmmmmmmmme
DAlarmFields	bmmmmebmmmme
DB_VERB_CHKPOINT	berbmmerbmmmmmme
DCF_M	bmers
DC_COMMENT	berbmmmmme
DC_OPEN	berbmme
DECL_FIELD_SIZE	bmmerbmmmerbmme
DICT_POOL_PER_VARYING	bmmerbmmerbmerbmmmmme
DIRECTION_NOTSET	bmmmmmmmerbmmmme
DJP_NEXT_STRUCTP	bmerbmmerbmmmmme
DKGREEN	bmmmmme
DLG_ADVANCED_SETTINGS	bmerbmmmmmmerbmmmmmme
DLList	bmmmme
DPR_OUTPUT_URL_PARAMETER_NAME	bmerbmmmmerbmerbmmmmmmmerbmme
DRIVE_REMOVABLE	bmmmerbmmmmmmme
DT_DEBUG	berbmmme
DYN_ANY_FACTORY_NAME	bmerbmerbmmmmmerbmme
Db_h_hash_callback	bersrbmmerbmmmmmme
DecimateConfig	bmmmmmmebmmmme
DefNodeWidth	bmebmmebmmme
DeleteModalityLanguageSupportAction	bmmmmebmmmmmmebmmmmmmebmmmmmebmmmme
DenoiseFFTWindow	bmmmmmebmmmmmmme
DestroyFlushEvent	bmmmmmebmmmebmmme
DestroyOidSequence	bmmmmmebmebmmmmmme
DialerCommand.CLT_UNBLOCK	bmmmmebmmmmmerbmerbmmmmme
DjentelParserEngineTreeConstants.JJTINDENT	bmmmmmebmmmmebmmmmebmmebmmmmmmmerbmmmmmmme
DoHooks	bebmmme
DropDownListSpriteCO	bmmebmmebmmebmmmmebe
DublinCoreExtension	bmmmmebmmebmmmmmmme
DummyListUI	bmmmebmmebe
EAGAIN	bmmmme
ECField	bmmmmme
EC_group_fp	berbmmmerbe
EF_LOST	berbmme
EL3RST	besbme
ENVVERB	bmmmmme
EOPNOTSUPP	bmmmmmmmme
ER_ILLEGAL_REFERENCE	berbmmmmmerbmmmmmmme
ESR_NORMAL_FONT_SIZE_DEFAULT	bmerbmmmmerbmmerbmmerbmmmmme
ESTRANGELO_SYRIAC	bmmmmmmmmerbmmmme
EUCKR_TYPICAL_DISTRIBUTION_RATIO	bmmmerbmmmmmerbmmmmmmmmmmerbmmme
EUDORAIMPORT_ADDRESS_BADSOURCEFILE	bmmmmmmmmmmerbmmmmmerbmmmmmmmmmmme
EncodeABC.value.const_refs	bmmmmebmerbmmmerbmmmerbmme
Enum.INT_ABOVE	bmmerbmerbmmme
ErrTimeout	bmebmmmmme
ExportXMIReferenceProvider	bmmmmebmmmmmmmmmmebmmmmmme
FC_USERID_HINT	berbmmmmerbmme
FFECOM_f2ccodeCHAR	bmmmmerssbmmmebmme
FFEEXPR_percentVAL_	bmmmmmerbmmmmmebmer
FFESTR_firstCALL	bmmmmerbmmmebmme
FFESTR_genioSIZE	bmmmmerbmmmebmme
FF_LOSS_COLORSPACE	berbmmerbmmmmmmmme
FORMATTER_BRACE_POSITION_FOR_ANNOTATION_TYPE_DECLARATION	bmmmmmmmerbmmmerbmmmmmmerbmerbmmmmmmmmerbmmerbmmmmmmmmme
FORM_DATAOBJECT_CONSTRUCTOR	bmmerbmmmmmmmmerbmmmmmmmmme
FPUL_REGS	bmmerbmme
FSMultipartFormDataReader	bmmmmmmmmmebmmebmmebmmmme
FT_New_Stream	berbmerbmmmme
FT_Outline_Oblique	berbmmmmmerbmmmmme
FX_SPELL_PARALYZE	berbmmmerbmmmmmme
FileActivator	bmmebmmmmmmme
FileMgrConstants.VMODULE_ACTION_SAVE	bmmebmebmmmmmmmerbmmmmmerbmmmmerbmme
FlowchartDiagramEditorPlugin.ID	bmmmmmmmebmmmmmebmmmmebmmmmerbe
ForrestManager.COMMAND_BUILD	bmmmmmebmmmmmerbmmmmmerbmmme
GC_push_all_stack_partially_eager	berbmmerbmerbmmmerbmmmmmmmerbmmme
GC_register_disappearing_link	berbmmmmmmerbmmmmmmmmmmerbmme
GConfClientGetDefaultType	bmmmebmmmmebmebmmmmmebmme
GFXBYTESPERPIXEL	bmmmmmmmmmmmmmme
GGGPP_CDMA2000	bmmmerbmmebmme
GL_COLOR	berbmmme
GL_COLOR_BUFFER_BIT	berbmmmerbmmmmerbme
GSN_FSAPPENDCONF	bmerbmmmmmmmmmme
GSN_FSAPPENDREQ	bmerbmmmmmmmmme
GSN_LQH_TRANSCONF	bmerbmerbmmmmmmme
GSN_LQH_TRANSREQ	bmerbmerbmmmmmme
GTK_MOZ_EMBED_FLAG_TOOLBARON	bmerbmerbmmmerbmmerbmmmmmmme
G_DATE_BAD_MONTH	srbmmerbmerbmmme
GenModFigure	bmebmebmmmme
GetAtkSignalName	bmebmebmmmmebmme
GetAudioSamplesPerSec	bmebmmmebmmmmmebmebme
GetCapabilitiesKvpRequestReader	bmebmmmmmmmmmmebmebmmmmmebmmmme
GetFirstEv	bmebmmmebe
GetHighestInlineParent	bmebmmmmmebmmmmebmmmme
GetMinRowHeight	bmebmebmebmmmme
GetNormalizedPathSegList	bmebmmmmmmmmebmmebmebmme
GetOfflineOpForKey	bmebmmmmmebebmebme
GetRuntime	bmebmmmmme
GetUpData_MLDONKEY	bmebebmmerbmmmmmme
GetWSIsEnabled	bmebmmebmmmmme
GtkStateType	bmebmmmebmme
Gvp	bme
HAVE_DECL_SYS_SIGLIST	bmmerbmmerbmerbmmmmme
HAVE_trunctfdf2	bmmerbmmmmmmmes
HF_LAMBDAFN	berbmmmmmme
HITField.Description	bmmmmmmerbmmmmmmmmme
HSoundsPreferencePanel	bmmmmmebmmmmmmmmebmmme
HZ_STATE_GB	berbmmmerbe
HandleUnregisterURLEchoEvent	bmmmmebmmmmmmmmebmmmmmebmmme
HistogramConfig	bmmmmmmmebmmmme
IAX_IE_CALLED_CONTEXT	bmerberbmmmmerbmmmmme
IActionProvider	bmmmmmebmmmmmme
ICY_METADATA_INTERVAL	bmerbmmmmmmerbmmmmmme
IClientDataItem	bmmmmmebmmebmme
ID3FID_YEAR	besbmerbmme
IDC_EDIT_DATETIME	bmerbmmerbmmmmmme
IDC_EDIT_QUAKE2	bmerbmmerbmmmes
IDC_METANAME	bmerbmmmmmme
IDC_TEXTWIN_COPY	bmerbmmmmmerbmme
IDC_UPDATESERVERCLIENT	bmerbmmmmmmmmmmmmmmmme
IDI_TESTPASSED	bmerbmmmmmmmme
IDI_UNINSTALL	bmerbmmmmmmme
IDL_node_new	bmerbmmerbme
IDL_type_fixed_new	bmerbmmerbmmmerbme
IDS_DL_RESUMENEXT	bmerberbmmmmmmmme
IDS_HSAV	bmerbmme
IDS_IRC_DISCONNECT	bmerbmerbmmmmmmmme
IDS_LASTSEEN	bmerbmmmmmme
IEC61883_AMDTP_FORMAT_IEC958_PCM	bmebmmmerbmmmerbmmmmerbmebmerbme
IFTypeManager.IF_ATTACHMENTS	bmmmmebmmmmmerberbmmmmmmmmme
IID_IHTMLElementCollection	bmerbmmmmmmmmmmebmmmmmmmme
IMAGE_BITMAP	bmmmerbmmmme
INIT_BLOCK_SIZE	bmmerbmmmerbmme
INTEL_SPINLOCKS	bmmmerbmmmmmmme
INT_ROW_HOLIDAYS_START	bmerbmerbmmmmmmerbmmme
IPC_PlatformSendMsg	bmerbmmmmmmebmmebme
ISBADADR	bmmmmmme
ITagLibErrors	bmmebmebmmmme
IbisSerializationOutputStream.enumClass	bmmebmmmmmmmmmmmebmmmmebmmmmerbmmebmmme
ImageMatrix.yy	bmmmebmmmmerbe
ImageToPDF	bmmmebebme
Individual.NOT_INHERITABLE	bmmmmmmmmerbmerbmmmmmmmmme
InitBrowserMenu	bmmebmmmmmebmme
InitLicTxt	bmmebmebme
InitThread	bmmebmmmme
InstantiationSet	bmmmmmmmmmmmebme
IonoStationEditAction	bmmebmmmmmebmmebmmmme
Is7bitNonAsciiString	besbmebmebmmmebmmmme
Item_func_lt	bmmerbmmerbe
JAVA_SIGNATURE_UNKNOWN	bmmerbmmmmmmmerbmmmmme
JAVA_T	bmmers
JAWE_AUTOSAVE_PROPERTYFILE_NAME	bmmerbmmmmmmerbmmmmmmmmmmerbmme
JCEProviderObject	bmmmmmmmmmebmmmme
JCasFunctionTag	bmmebmmmmmmebme
JDBCAppender.PASSWORD_OPTION	bmmmmmmmmmmerbmmmmmmerbmmmme
JRMeterChartFactory	bmmmmmebmmmebmmmmme
JSD_GetJSScript	bmerbmebmmmmmme
JSPRegularExpressions.HTML_A_PATTERN	bmmmmmmmmebmmmmmmmmmerbmmersrbmmmmme
JS_GetFrameAnnotation	berbmebmmmebmmmmmmmme
JS_NEW_LOCK	berbmerbmme
JTRC_ADOBE	bmmerbmmme
JXBroadcast	bmmmmmmmmme
JameleonScriptExceptionTest	bmmmmmmebmmmmebmmmmmmmebmme
Java2ObjectTypeConverter	bmmesbmmmmebmmebmmmmmmme
JavassistInstrumentorEngineTaskTest	bmmmmmmmebmmmmmmmmmmebmmmmebmmebmme
JmiChangeSet	bmebmmmmebme
KERN_PAIR_KPY	bmmerbmmerbme
KeyFallback	bmebmmmmmme
Keyboard.KEY_LCONTROL	bmmmmmmerbmerbmmmmmme
L1_WO_WAEN	ssrberbmme
LARGE_NUM_SOCKETS	bmmmerbmerbmmmmme
LBCarryMask	bmmmmmebmme
LC_LOAD_DYLIB	berbmmerbmmme
LDAP_CONTROL_PWEXPIRED	bmmerbmmmmmerbmmmmmmme
LEX_INFINITY	bmerbmmmmmme
LIBERIA_ID	bmmmmmerbe
LIS_SUCCESS	bmerbmmmmme
LL_DEBUG	berbmmme
LMTOS_LCP_CONCLUDING	bmmmerbmerbmmmmmmmme
LM_SELECTITEM	berbmmmmmmmme
LOADCHOICES	bmmmmmmmmme
LOCKED_DBT	bmmmmerbme
LOCKED_OBJ_GET_PROTO	bmmmmerbmerbmerbmmme
LOGON_PRIVILEGE_NAME	bmmmerbmmmmmmmerbmme
LOOKUP_COMPLETE	bmmmmerbmmmmmme
LPCM_AUDIO	bmmerbmmme
LProgressBar	bmmmmmmmebme
LSold.Mode	bmmmerbmme
LTRAmPTable	bmmmebmmmme
LVBKIMAGE	bmmmmmmme
LdapAttrbConst.ATTRIBUTE_MULTI_VALUED	bmmebmmmebmmmerbmmmmmmmerbmmmerbmmmme
Link.INVERSEPROP	bmmerbmmmmmmmmme
LogReaderSOAPService	bmebmmmmebmmmmmmmmme
MAC_STARTUP	bmerbmmmmme
MALAY	bmmme
MAP_VIEW_CENTRE_LONG	bmerbmmerbmmmmerbmme
MAXUSERNAMELEN	bmmmmmmmmmmmme
MAX_URI_SIZE	bmerbmerbmme
MD.Tempo	berbmmme
MESSAGE_TYPE_STOP_ASSOC	bmmmmmerbmmerbmmerbmmme
MF_ENABLED	berbmmmmme
MIDIError	bmmmmmmme
MIFValueSetter	bmmmmmmebmmmme
MIN_NUMBER_OF_SIG_PER_DO_JOB	bmerbmmmmerberbmerbmerberbme
MIN_PROBABILITY	bmerbmmmmmmmmme
MJ_FAILED_MARSHALING	berbmmmmerbmmmmmmmme
MK_LDAP_OBJECT_CLASS	berbmmerbmmmmerbmmme
MLetTag.ArgTag	bmmebmerbmebme
MNG_CANNOTBEEMPTY	bmerbmmmmmmmmmmme
MNG_FN_INIT_SEEK	bmerberbmmerbmme
MNG_FN_PROCESS_DISPLAY_TRNS	bmerberbmmmmmerbmmmmmerbmme
MNG_FN_WRITE_FRAM	bmerberbmmmerbmme
MNG_FN_WRITE_JDAT	bmerberbmmmerbmme
MOS1phiGiven	bmesbmebmmme
MOS2_CQBD	bmesrbmme
MOS2bulkJctPotential	bmesbmmebmebmmmmmmme
MOS3_VGS	bmesrbme
MOZILLA_VERSION_PROP	bmmmmmerbmmmmmerbmme
MP4GetTrackDuration	besbmebmmmebmmmmmme
MP4SetTrackTimeScale	besbmebmmmebmmebmmme
MP4TableProperty	besbmmmebmmmmmme
MPEG1_BUFFERINFO_LENGTH	bmmesrbmmmmmmmmerbmmmme
MP_RESUMENEXT	berbmmmmmmmme
MSG_DNS_LOOKUP_COMPLETE	bmerbmerbmmmmerbmmmmmme
MY_KEEP_PREALLOC	berbmmerbmmmmmme
MY_LEX_END_LONG_COMMENT	berbmerbmerbmmerbmmmmme
MaxNoOfAttemptsC	bmebebebmmmmmmes
MedlineImporter	bmmmmmebmmmmmme
MenuBuilder.ATTACK_MENU_RELATED_DEST_1	bmmebmmmmmerbmmmmerbmmerbmmmmmerbmmers
MenuItemInfo.cch	bmmebmmebmmerbme
MetaDoorExceptionHandler	bmmebmmebmmmmmmmebmmmmme
MimeMultipartSignedCMS_initialize	bmmebmmmmmmmebmmmmebmerbmmmmmmmme
ModifiableTableChangeEvent	bmmmmmmmmebmmmebmmmmebmmme
NAMEKeyword	bmmmmmmmmme
NAME_STATE	bmmerbmmme
NMEA_strings	bmmerbmmmmme
NOFUN	bmmme
NSCP_MAPIDeleteMail	bmmerbmmmmmmmmebmme
NSC_SignEncryptUpdate	bmerbmmebmmmmmebmmmme
NSSCMSRecipientInfoID_KeyTrans	bmmmmmmmmmmmmmebmmeberbmebmmme
NSS_CMSDigestContext_FinishSingle	bmerbmmmmmmmebmmmmmerbmmmmebmmmme
NS_CHARSET_DETECTOR_CONTRACTID_BASE	berbmmmmmerbmmmmmmerbmmmmmmmmerbmme
NS_DECL_NSIWMPSETTINGS	berbmmerbmmmmmmmmmmmme
NS_ERRORSERVICE_CONTRACTID	berbmmmmmmmmmmerbmmmmmmmme
NS_FRAME_IS_COMPLETE	berbmmmerberbmmmmmme
NS_FRAME_TRACE_REFLOW_OUT	berbmmmerbmmmerbmmmmerbme
NS_HKEY_CURRENT_USER	berbmmerbmmmmmerbmme
NS_HTTP_STICKY_CONNECTION	berbmmerbmmmmerbmmmmmmmme
NS_IROBOTSINK_IID	berbmmmmmmmmerbme
NS_LOADER_DATA_ALLOC_STEP	berbmmmmerbmmerbmmmerbmme
NS_MATHML_PSEUDO_UNIT_LSPACE	berbmmmmerbmmmmerbmmerbmmmme
NS_NET_STATUS_WROTE_TO	berbmerbmmmmerbmmmerbe
NS_NNTPINCOMINGSERVER_CONTRACTID	berbmmmmmmmmmmmmmmmmerbmmmmmmmme
NS_PRINTINGPROMPTSERVICE_CONTRACTID	berbmmmmmmmmmmmmmmmmmmmerbmmmmmmmme
NS_QUICKLAUNCH_RUN_KEY	berbmmmmmmmmmerbmerbme
NS_REGRESSION_TESTER_CID	berbmmmmmmmmerbmmmmerbme
NS_SCHEMAANYPARTICLE_CONTRACTID	berbmmmmmmmmmmmmmmmerbmmmmmmmme
NS_STYLE_CURSOR_DEFAULT	berbmmmerbmmmmerbmmmmme
NS_STYLE_VERTICAL_ALIGN_MIDDLE	berbmmmerbmmmmmmerbmmmerbmmmme
NS_UNICODETOCP855_CID	berbmmmmmmmmmebmerbme
NTLMSSP_NEGOTIATE_NTLM	bmmmmmerbmmmmmmmerbmme
NT_STATUS_EVENTLOG_FILE_CHANGED	berbmmmmerbmmmmmmerbmmerbmmmmme
NXKeyDelete	bmmmebmmmme
N_EL_FRAME	srberbmmme
NaNIndices.length	bebmmmmmmerbmmmme
NewContainerDialog_error_enterpath	bmebmmmmmmmebmmmmerbmmmerbmmmmmmme
NewEventHandlerUPP	bmebmmmebmmmmmebme
NextFocusMatcher	bmmebmmmebmmmmme
OBJ_SZ_TO_BLOCKS	bmerberberbmmmme
OFdefIOs	bmmmebme
OPT_STOP_DATETIME	bmerbmmerbmmmmmme
OP_TYPEUPTO	berbmmmmmme
OS_THREAD_PRIORITY_ABOVE_NORMAL	berbmmmmerbmmmmmmerbmmmerbmmmme
OUTF_W	bmmers
OnFileSaveas	bebmmebmmmme
OnMsgClose	bebmebmmme
OnOptionDisabled	bebmmmmebmmmmmme
Order.LT	bmmmerbe
PAR_INTEGERKEY	bmerbmmmmmmmme
PCS_NOTVERIFIED	bmerbmmmmmmmmme
PK11_ALWAYS	beberbmmmme
PK11_SETATTRS	beberbmmmmmme
PKCS11Constants.CKM_RC5_ECB	bmmebebmmmmmmmerbmerbesrbme
PKCS9	bmmes
PLUGINS_DIR_NAME	bmmmmmerbmerbmme
PLUGIN_LOG_NAME	bmmmmerbmerbmme
PLUS_OP__START_OFFSET	bmmerberrbmmmerbmmmme
PL_strdup	berbmmmme
PNG_WRITE_PACK_SUPPORTED	bmerbmmmerbmmerbmmmmmmme
POLYGON_EXCL	bmmmmmerbmme
PROP_TASK_DESC	bmmerbmmerbmme
PRRecvfromFN	bmmmmmmmmebe
PRSeek64FN	bmmmmebebe
PR_CONTACT_DEFAULT_ADDRESS_INDEX	berbmmmmmerbmmmmmerbmmmmmerbmmme
PR_CallOnce	berbmmebmme
PR_HOME_ADDRESS_COUNTRY_W	berbmmerbmmmmmerbmmmmmers
PR_INSERT_LINK	berbmmmmerbmme
PSY_ALPHA_VERSION	bmerbmmmerbmmmmme
PS_COMPLETE	berbmmmmmme
PdfAnnotPlugin.EDITOR_ID	bmebmmmebmmmmerbmmmmerbe
Ph_CURSOR_QUESTION_POINT	berbmmmmerbmmmmmmerbmmme
Pk11Install_Platform	bebebmmmmmerbmmmmmme
PluginVClient	bmmmmebmmmmme
PovReflectionGeneImpl	bmebmmmmmmmmebmmebmme
PrefetchHref	bmmmmmmebmme
ProcessorC	bmmmmmmmes
ProjectElement.INCLUDE_BASE_TAG	bmmmmmebmmmmmerbmmmmmerbmmerbme
Project_ID3.chemin_mp3	bmmmmmerbesrbmmmmerbes
Pt_ARG_MOZ_AUTH_CTRL	berbmerbmerbmmerbmme
PyEval_ReleaseThread	bebmmerbmmmmmebmmmme
QWheelEvent	bmmmmebmmme
Q_isalpha	srbmmmmme
QoSDrxAlarmEventReceiverEventHandlerImplShell	bebmmebmmmebmmmebmmmmmmebmmmebmmmmmebmmebmmme
Qt.Key.Key_Up	berbmerbmerbe
QueryField.field_type.alpha_field	bmmmebmmmerbmmmerbmmerbmmmerbmmme
RAW_CD_SECTOR_SIZE	bmerberbmmmmerbmme
RBACResourceTypeEntry	bmmmmmmmmmmebmmebmmme
READ_FIFO	bmmerbmme
REFTREES_CHILDREFID	bmmmmmmerbmmmmmmmme
REGISTEREDBY_AD_Reference_ID	bmmmmmmmmmmerberbmmmmmmmerbe
RELOAD_MIN_TIME	bmmmmerbmerbmme
REPEAT_TYPE_DAILY	bmmmmerbmmerbmmme
RMIApp	bmmmme
ROT_Y_LEFT	bmersrbmme
RaistlinServlet	bmmmmmmebmmmmme
Record.PROC_EXEC_FAILURE	bmmmmerbmmerbmmerbmmmmme
RefondeDialogProprietesProjet	bmmmmmebmmmmebmmmmmmmmebmmmme
RegisterUtf8	bmmmmmmebmes
RegistryMessages.meta_registryCacheWriteProblems	bmmmmmmebmmmmmmerbmmerbmmmmmmebmmmebmmmebmmmmmme
Resources.EXT_PSX	bmmmmmmmerbmerbme
SBS_VERT	bmerbmme
SCRAMBLED_PASSWORD_CHAR_LENGTH	bmmmmmmmerbmmmmmmerbmmerbmmmme
SECKEYKeyDBHandle	bmmmmmmmebmmmmmme
SECUREOSF	bmmmmmmme
SECURE_RANDOM_ALGO_NAME	bmmmmerbmmmmerbmmerbmme
SEC_SignData	bmerbmmebmme
SET_AND_EXPR	bmerbmerbmme
SF_FORMAT_SD2	berbmmmmerbes
SHOW_SSL_CTX_SESS_ACCEPT	bmmerbmerbmerbmmerbmmmme
SHOW_SSL_CTX_SESS_HITS	bmmerbmerbmerbmmerbmme
SIMPLE_SCROLL_MODE	bmmmmerbmmmmerbmme
SMB_GROUP_QUOTA_TYPE	bmerbmmmerbmmmerbmme
SMTP_TLS_RESPONSE	bmmerbmerbmmmmmme
SND_PCM_HW_PARAM_PERIODS	bmerbmerberbmmmerbmmmmme
SND_SEQ_EVENT_INSTR_LIST	bmerbmerbmmmerbmmmerbmme
SOUNDTRACK_WEATHERAMBIENCE	bmmmmmmmmerbmmmmmmmmmmmmme
SPL_ARCH_W32ALPHA	bmerbmmersbebmmme
SPOOL_Q_REPLYOPENPRINTER	bmmmersrbmmmmmmmmmmmmmme
SQLCOM_SHOW_PROCESSLIST	bmmmmerbmmerbmmmmmmmmme
SQL_DIRECTORY_ATTR	bmerbmmmmmmmerbmme
SSL_ERROR_RX_MALFORMED_APPLICATION_DATA	bmerbmmmerberbmmmmmmmerbmmmmmmmmmerbmme
SSL_ERROR_RX_UNKNOWN_ALERT	bmerbmmmerberbmmmmmerbmmme
SSL_set_accept_state	bmerbmerbmmmmerbmmme
STATEMENTEDIT_BUF_SIZE	bmmmmmmmmmmmerbmerbmme
SUBLANG_ARABIC_EGYPT	bmmmmmerbmmmmerbmmme
SUNOS5DL	bmmmesbe
SV_AreaEntities_r	berbmmebmmmmmmers
SV_ConSay_f	berbmebmers
SV_RankReportStr	berbmmebmmmmebme
SYSTEM_AGENTS_GROUP_NAME	bmmmmerbmmmmerbmmmerbmme
SaveDocumentInternal	bmmebmmmmmmebmmmmmme
ServerConfig.pieceImageFile	bmmmmebmmmmerbmmmebmmmebmme
ServerDoesntSupportACL	bmmmmebmmmmebmmmmmebme
SetLeaveAsAscii	bmebmmmebebmmme
SetMsgHdrCacheSize	bmebmebmebmmmebmme
SetUnusedInput	bmebmmmmebmmme
ShareResourceEvent.ET_ATTRIBUTE_CHANGED	bmmmebmmmmmmebmmmerberbmmmmmmmerbmmmmme
SimpleCpcClient::Parser_t::ParserStatus	bmmmmebmebmmmmessbmmmmersssbmmmmebmmmme
SmtpHeadersInterface.CONTENT_TRANSFER_ENCODING	bmmebmmmmmebmmmmmmmerbmmmmmerbmmmmmmerbmmmmmme
SprawdzTypySkladnikow	bmmmmmebmmebmmmmmmmme
StartServer_MenuInit	bmmmebmmmmerbmmebmme
StornoDialog	bmmmmebmmmme
StrongBinaryEncryptor	bmmmmebmmmmebmmmmmmme
StyleDisplayImpl	bmmmebmmmmmebmme
T1_Block.T1_BLOCK_R_OK	ssrbmmmerssrbmmmersrbe
TAG_NL_VAR	bmerberbme
TBACKGND	bmmmmmme
TBBTN_TRANSFERS	bmmmerbmmmmmmme
TEST_NO_UUID_STRUCT	bmmerberbmmerbmmmme
TFNGui.ADD_TRANSITION	bmmmmerbmerbmmmmmmmme
TMADicotomicIndexedItems	bmmmmmmmmmmebmmmmmebmmme
TME_HOVER	bmerbmmme
TOPREVFILE	bmmmmmmmme
TRACEBACK_FETCH_ERROR	bmmmmmmmerbmmmerbmmme
TRAinfo	bmmmmme
TRG_NUM_REQUIRED_PARAMETERS	bmerbmerbmmmmmmerbmmmmmmmme
TRX_SYS_MYSQL_LOG_NAME_LEN	bmerbmerbmmmerbmerbmmerbme
TT_PEEK_LONG	berbmmerbmme
TT_Round_To_Grid	berbmmmerberbmme
TX_PATTERN_DEBUG	berbmmmmmerbmmme
TYPE_CONFIG_TRACK	bmmerbmmmmerbmmme
Tags.CONST	bmmerbmmme
TavernaIcons.importUrlIcon	bmmmmmebmmmerbmmmmebmebmme
TeamB_correctionButton.addActionListener	bmmesrbmmmmmmmmebmmmmerbmebmmmmebmmmmmme
Terrain_DrawXY	bmmmmmerbmmebe
ThrowCOMError	bmmmebmmmmmme
TraitSelectorSeqHelper	bmmmebmmmmmmebmebmmmme
TypeParameter.PARAM_COMMENT	bmmebmmmmmmmerbmmmerbmmmmme
Types.BIGINT	bmmmerbmmmme
UI_POPUP_INFO	berbmmmerbmme
UMLMetafacadeProperties.DEFAULT_IDENTIFIER_VISIBILITY	bmmmmmmmmmmmebmmmmmmmmerbmmmmmerbmmmmmmmmerbmmmmmmmme
UNI_LEFT_SINGLE_QUOTE	bmerbmmerbmmmmerbmmme
UPD_MM_DEL_ARRAY	bmerberbmerbmmme
UPRIGHT_RESIZE	bmmmmmerbmmmme
USE_FREETYOE	bmerbmmmmmme
USE_NC_EXTENSION	bmerberbmmmmmmme
USE_SETREUID	bmerbmmmmmme
UnRegisterSession	bebmmmmmmebmmmmme
UnicodeNotFromInputMethodHandler	bmmmmmebmebmmebmmmebmmmmebmmmmme
UnregisterContentPolicy	bmmmmmmmmebmmmmmebmmmme
UpdateResFile	bmmmmebmebmme
UserProperties.APP_RSRC_PREFIX	bmmebmmmmmmmmerbmerbmmerbmmmme
VCARD.PRODID	bmmmerbmmmme
VCARD_LDAP_IBMMAIL_TYPE	bmmmerbmmerbmmmmmerbmme
VCCityProp	bmmmmebmme
VCFullNameProp	bmmmmebmmebmme
VLNEXT	bmmmme
VerifyRuntime	bmmmmebmmmmme
VirtualGraphics.bgcolor	bmmmmmebmmmmmmerbmmmmme
WC_SCROLLBAR_STRING	berbmmmmmmmerbmmmme
WH_DEBUG	berbmmme
WIFSIGNALED	bmmmmmmmmme
WSAEMSGSIZE	bmmmmmmmmme
WSA_GRANT_ACCESS_TO_ALL	bmerbmmmerbmmmmerberbme
WS_CARBON	berbmmmme
WebServiceLifecycleHandler	bmebmmmmmebmmmmmmmebmmmmme
WindowNoPanel	bmmmmebebmmme
WorkbenchPlugin.PI_WORKBENCH	bmmmmmmmebmmmmerberbmmmmmmme
XC_hand2	berbmmes
XCreateGC	bmmmmmebe
XK_KP_Delete	berberbmmmme
XMLConfig.TYPEDEF_LIST_ATTR	bmmmmmmmerbmmmmmerbmmerbmme
XMLCyclePrinter	bmmmmmmebmmmmme
XMLDocumentClipboard	bmmmmmmmmmebmmmmmmme
XPC_Log_Finish	bmerbmerbmmmme
XPT_NewXDRState	bmerbmebmmmmmme
XVID_KEYFRAME	bmmerbmmmmmme
XVID_ME_QUARTERPELREFINE8_RD	bmmerberbmmmmmmmmmmmmmmesrbe
XpuGetResolution	bmebmebmmmmmmmme
XtMoveWidget	bebmmebmmmme
XtNminWidth	bebmmebmmme
Y4M_ERR_BADEOF	sssrbmerbmmmme
YNormalized	bmmmmmmmmme
ZFULL_FRAGRECORD_ERROR	bmmmerbmmmmmmmmerbmmme
ZT_DIAL	berbmme
_AFX_CMDTARGET_GETSTATE	rbmerbmmmmmmmerbmmmmmme
_BDF_DWIDTH	rbmerbmmmme
_F_INOUT	rsrbmmme
_IO_peekc	rberbmmme
_Mult_Inner_Loop	rbmmerbmmmerbmme
_PR_HAVE_LARGE_OFF_T	rberbmmerbmmmerbmers
_PR_MD_MEM_UNMAP	rberberbmerbmmme
_PR_MD_OPEN_FILE	rberberbmmerbmme
_PT_PTHREAD_MUTEX_IS_LOCKED	rberbmmmmmerbmmmerberbmmmme
__db_refresh	rrberbmmmmme
__db_vrfy_freelist	rrberbmmerbmmmmmme
__dbreg_init_print	rrbmmmerbmmerbmmme
__mpool_get	rrbmmmerbme
__os_segdata_find_byname	rrberbmmmmmerbmmerbmmmme
__rw_exception	rrberbmmmmmmme
__txn_prepare_proc	rrbmerbmmmmmerbmme
_gridComponents	rbmmebmmmmmmmme
_gsl_vector_float_view_array_with_stride_	rbmerbmmmmerbmmmerbmmerbmmmerbmmerbmmmmer
_httpProtocolVersion	rbmmebmmmmmmebmmmmme
_maxWallTime	rbmebmmebmme
_pointBorderColour.setSelectedIndex	rbmmmebmmmmebmmmmerbmebmmmmmmebmmme
_pr_solx86_clock_gettime	rberbmmeberbmmmerbmmmmme
_snd_pcm_scope_level	rbmerbmerbmmmerbmmme
_strSearchTree	rbmebmmmmebmme
a.ecart_	srbmmmer
aCallback	sbmmmmmme
aConstructorCID	sbmmmmmmmmmebme
aDesiredWidgetSize.width	sbmmmmmebmmmmebmmerbmmme
aFrameNum	sbmmmebme
aMinVerticalPos	sbmebmmmmmmebme
aNumPagesX	sbmebmmmes
aP3PHeader	sssbmmmmme
aRGBMap	sbmmmme
aRowEndY	sbmebmes
aSVG.mStrokeOpacity	sbmersbmmmmebmmmmme
aTransferables	sbmmmmmmmmmmme
aUsesOCSP	sbmmebmme
aXMLTerminal	sbmmmmmmmmme
a_explanation	srbmmmmmmmmme
aassettings.phys_watergravity	bmmmmmmmmmerbmmerbmmmmmmmmmme
absII	bmebe
ac3_bit_allocation.dbknee	besrbmerbmmmmmmmmerbmmmme
actual_type	bmmmmerbmme
addActionSet	bmebmmmmebme
addBpelProcessUrl	bmebmmebmmmmmebme
addDocFVsToFile	bmebmebmebebmme
addLibfileset	bmebmmmmmmmme
addResumeOperation	bmebmmmmebmmmmmmme
addUsersToRol	bmebmmmebebme
addWall	bmebmme
add_decroche	bmerbmmmmmme
addrBook	bmmebmme
addrncase	bmmmmmmme
adds	bmme
adpcm_encode_init	bmmmerbmmmmerbmme
ads_sid_to_name	bmerbmerberbmme
agd_serv_struct.fkt	bmerbmmerbmmmmerbme
ainfo_class_initialized	bmmmerbmmmerbmmmmmmmmme
alloc_EXPR_LIST	bmmmerbmmerbmme
allows_mem	bmmmmerbme
alsa_lisp_t	bmmerbmmers
anSsrc	bebmme
ap_cpystrn	berbmmmmme
apath.inner_box	bmmmerbmmmerbme
apiScanRec	bmebmmebme
appParam	bmebmmme
approxlib_ml	bmmmmmmmerbe
apr_fcvt	bmerbmme
argind	bmmmme
arglex_token_update_not	bmmmmerbmmmerbmmmmerbme
argsbuffer	bmmmmmmmme
art_pixbuf_free_shallow	bmerbmmmmerbmmerbmmmmme
asm_high_label	bmerbmmerbmmme
ast_dsp_get_tcount	bmerbmerbmerbmmmme
ast_rtp_lookup_code	bmerbmerbmmmmerbmme
ast_say_datetime	bmerbmerbmmmmmme
atk_state_set_add_state	bmerbmmmerbmerbmerbmmme
attConfigs	bmebmmmmme
attractorCount	bmmmmmmmebmmme
attrsExp	bmmmebme
audio_ch	bmmmerbe
audio_strerror	bmmmerbmmmmmme
authFinished	bmmebmmmmmme
authnokey	bmmmmmmme
autohelper_func	bmmmmmmmmerbmme
avg_pixels8_iwmmxt	bmerbmmmmesrbmmmme
aviSynthPanel	bmebmmmebmmme
b.m_inline	srsrbmmmme
b.m_partsize	srsrbmmmmmme
bAlphaIsValid	sbmmmebebmmme
backfill_outside_liberty.pos	bmmmmmmerbmmmmmerbmmmmmerbme
base_init_list	bmmerbmmerbmme
base_source_filenames	bmmerbmmmmerbmmmmmmme
bb_reg_last_clobbers	berbmerbmmerbmmmmmme
bcBitCount	bebmebmmme
bctu	bmme
bestbm.descent	bmmmmerbmmmmme
bestdot	bmmmmme
beyond_eor	bmmmmerbme
bgMeans	bebmmme
bglight	bmmmmme
bindingUri	bmmmmmebme
bisexec_environment	bmmmmmerbmmmmmmmmme
bitmap_choice_mult_item	bmmmmerbmmmmerbmmerbmme
bitsx	bmmme
bmInfo.bmHeight	bebmmerbebmmmme
bmwidth	bmmmmme
body.cons.numSubs	bmmerbmmerbmebmme
bodyname	bmmmmmme
branch_gt	bmmmmerbe
bs_write_ue	berbmmmerbe
bulletinUid	bmmmmmmebme
buttonEl	bmmmmebe
byCFGB	bebmme
c.ll_corner	srberbmmmme
c_pointcontents	srbmmmmmmmmmmme
cachePtr	bmmmebme
calcHeight	bmmebmmmme
calcmandfpasmstart	bmmmmmmmmmmmmmmmme
callsite	bmmmmmme
campspot_t	bmmmmmmers
canEditAsUserAdmin	bmebmmebebmmebmmme
catalogdownload	bmmmmmmmmmmmmme
cattrinbufFileSize	bmmmmmmmmebmmebmme
cbuf.data	bmmerbmme
cchMatchingPath	bmebmmmmmmebmme
celtype	bmmmmme
certcount	bmmmmmmme
cf_2d_decode	berssrbmmmme
cfirstfreelcpConnect	bmmmmmmmmmmmebmmmmme
cgm_clip_indicator	bmerbmmerbmmmmmmme
cgs.media.redScoredSound	bmerbmmmerbmebmmmmebmmme
chain_alloced	bmmmerbmmmmme
channelmodify	bmmmmmmmmmmme
charbuff	bmmmmmme
charstring_execchar	bmmmmmmmmerbmmmmmme
checkIfAllBound	bmmmebebmebmmme
checkStartThread	bmmmebmmmebmmmme
check_hosts_equiv	bmmmerbmmmerbmmme
chk2modws	bmesbmmme
chk_status	bmerbmmmme
choice_syrecos	bmmmmerbmmmmme
chpw_req.data	bmmerbmerbmme
chroma.blue.x	bmmmmerbmmers
ci_collection_end	berbmmmmmmmmerbme
cipbp.dirInfo.ioFlAttrib	bmmmerbmebmmerbebebmmmme
cl.timeoutcount	berbmmmmmmmmmme
classEntryTmpl.className	bmmmebmmmebmmerbmmmebmme
clblPageCounter	bmmebmmebmmmmme
clcpConnectsize	bmmebmmmmmmmmme
cleanup_elt	bmmmmmerbme
cli_add_queue_member	bmerbmerbmmmerbmmmme
client_procs.copy_for	bmmmmerbmmmerbmmerbme
cloneChoice	bmmmebmmmme
cm_xorot	berbmmme
cmap_fields	bmmerbmmmme
cmdZoomOut_mouseReleased	bmebmmebmerbmmmebmmmmmme
cmd_PrefillForm	bmerbmmmmmebmme
cmd_stop	bmerbmme
cmmfCertificate	bmmebmmmmmmmmme
cmmf_CertOrEncCertSetCertificate	bmmerbmmebebmebmmebmebmmmmmmmmme
cmodel_calculate_max	bmmmmerbmmmmmmmerbme
col3.green	bmesrbmmme
colorBoldCyan	bmmmebmmebmme
com.adaptiveplanning.system.SystemConfig	bmerbmmmmmmmmmmmmmmerbmmmmerbmmmmebmmmme
com.agical.rmock.core.expectation.modification.MultiplicityModifier	bmerbmmmmerbmmmerbmmerbmmmmmmmmmerbmmmmmmmmmmerbmmmmmmmmmmebmmmmmme
com.apelon.dts.client.namespace.Namespace	bmerbmmmmerbmerbmmmmerbmmmmmmmerbmmmmmmme
com.capgemini.mda.model.Visitor	bmerbmmmmmmmerbmerbmmmerbmmmmme
com.corendal.netapps.framework.workflow.writedatafactories.ProcessExecutionDateFactory	bmerbmmmmmmerbmmmmmerbmmmmmmmerbmmmmmmerbmmmmmmmmmmmmmmmmerbmmmmmebmmmmmmmebmmebmmmmme
com.esiglo.framework.core.apploader.security.jaxb.SecurityAuthorization	bmerbmmmmerbmmmmmmmerbmmerbmmmmmmmerbmmmmmmerbmmerbmmmmmmebmmmmmmmmmmme
com.greendiamond.rivernorth.ui.SelectionListener	bmerbmmmmmmmmmmerbmmmmmmmmerberbmmmmmmmebmmmmmme
com.gridsystems.module.api.ApiRegisteredType	bmerbmmmmmmmmmerbmmmmerbmerbmebmmmmmmmmebmme
com.icodeon.services.cmi.InteractionType	bmerbmmmmmerbmmmmmmerbmerbmmmmmmmmmebmme
com.kbquest.util.resource.DisposalQueueHandler	bmerbmmmmmerbmmerbmmmmmmerbmmmmmmebmmmebmmmmme
com.kopiright.bytecode.classfile.Member	bmerbmmmmmmmerbmmmmmmerbmmmmmmmerbmmmme
com.projity.pm.scheduling.SchedulingRule	bmerbmmmmmerberbmmmmmmmmerbmmmmmmmmebmme
com.projity.pm.snapshot.SnapshottableImpl	bmerbmmmmmerberbmmmmmmerbmmmmmmmmmmmebmme
com.sun.rave.web.ui.component.Label	bmerbmerbmmerbmerberbmmmmmmmerbmmme
com.sun.rave.web.ui.component.TableRowGroup	bmerbmerbmmerbmerberbmmmmmmmerbmmmebmebmmme
com.sun.star.i18n.KParseTokens	bmerbmerbmmersbesrbmmmmebmmmme
com.sun.tools.internal.ws.util	bmerbmerbmmmerbmmmmmmerberbmme
com.sun.tools.javac.main.JavacOption.HiddenOption	bmerbmerbmmmerbmmmerbmmerbmmmebmmmmerbmmmmebmmmme
com.wm.povclipse.property.megapovxrs.ServerTab	bmerberbmmmmmmmerbmmmmmmerbmmmmmmmmerbmmmmebme
com.xerox.VTM.engine.LongPoint	bmerbmmmerbmerbmmmmerbmmebmmme
commentBooleans	bmmmmmebmmmmmme
compNameBytes.length	bmmebmmebmmmerbmmmme
completeDropTrigger	bmmmmmmebmmebmmmmme
compress_init	bmmmmmmerbmme
computeBreakpointAdornmentFlags	bmmmmmebmmmmmmmmebmmmmmmmebmmme
computedMinHeight	bmmmmmmebmebmmmme
conf.lists.indexed	bmmerbmmmerbmmmmme
config.yellow	bmmmmerbmmmme
configuration.overview	bmmmmmmmmmmmerbmmmmmme
conn_options.secmode	bmmerbmmmmmerbmmmmme
connectpath	bmmmmmmmmme
consumeUnmappedDatastoreField	bmmmmmebmmmmmmebmmmmmmmebmmme
containerinfo	bmmmmmmmmmmme
contextSupport.createManagedCollection	bmmmmmebmmmmmerbmmmmebmmmmmebmmmmmmmme
contractidString	bmmmmmmmmebmmmme
convertOB	bmmmmmebe
corrigeAngles	bmmmmmebmmmme
cos_lat_M_cos_lon	bmerbmersrbmerbme
createChargeLabel	bmmmmebmmmmebmmme
createFDC	bmmmmebme
createHistoryFeedPlugin	bmmmmebmmmmmebmmebmmmme
createJMSAdapter	bmmmmebmmmmmmmme
createResourceHandler	bmmmmebmmmmmmebmmmmme
createVerCurso16	bmmmmebmebmmmebe
crlfHeaders	bmmebmmmmme
crmf_create_prtime	bmmerbmmmmerbmmmme
cryptoMech	bmmmmebmme
crypto_flags	bmmmmerbmmme
csSEI.fMask	bebmersbmme
cs_file_sec	berbmmerbme
ctimebar_h	bmmmmmmers
ctop	bmme
curHdr	bmebme
cur_client.reg.isreg	bmerbmmmmerbmerbmmme
currentAppPosition.y	bmmmmmebmebmmmmmmers
currentCtx	bmmmmmebme
customLayoutParameter.pageNumber	bmmmmebmmmmebmmmmmmmerbmmebmmmme
dDelayed	sbmmmmme
dInf.widthMember	sbmerbmmmebmmmme
d_rcode	srbmmme
databufptr	bmmmmmmmme
dayLengthLabel	bmebmmmmebmmme
dbArray	bebmmme
dbObj.ward_id	bebmerbmmerbe
dbc_ctp	bmerbme
dbt	bme
dc1394_start_iso_transmission	bebmmerbmmmerbmerbmmmmmmmmmme
dcA_Partner	besrbmmmmme
de.anomic.tools.dirlistComparator	berbmmmmerbmmmerbmmmmmebmmmmmmmme
deGappedConsensus	bebmmmmebmmmmmmme
deadsec	bmmmmme
dec.signature_	bmerbmmmmmmmer
declLambda	bmmebmmmme
delWalk	bmebmme
del_l	bmers
del_visible_faces	bmerbmmmmmerbmmme
deleteUbication	bmmmmebmmmmmmme
dev_proc_fill_mask	bmerbmmerbmmerbmme
device_prefs	bmmmmerbmmme
dfield_copy_data	bmmmmerbmmerbmme
di.pDatatype	bersbmmmmmme
dialogMsg	bmmmmebme
dialog_cb	bmmmmerbe
dictname	bmmmmmme
dirPropCount	bmebmmebmmme
dirYoffset	bmebmmmmme
dirst	bmmme
displayOptionsInfo.brightness.maxvalue	bmmmmmebmmmmmebmmerbmmmmmmmmerbmmmmmme
div_r	bmers
dladdr	bmmmme
dll_eth_get_work	bmerbmerbmerbmme
doCarteCharacters	bebmmmebmmmmmmmme
do_jump_for_compare	berbmmerbmerbmmmmme
do_layer3_sideinfo	berbmmmesrbmmmmmme
do_list_fn	berbmmerbe
do_unlink	berbmmmme
dollar_in_ident	bmmmmerberbmmme
domain_obj	bmmmmerbme
domss	bmmme
dop.pdriv	bmerbmmme
dosrcs	bmmmme
double_min	bmmmmerbme
dp_conf_t	berbmmers
dpre	bmme
dragAddNode.drawy	bmmebmebmmerbmmme
dragitem.fsSupportedOps	bmmmmmmerbebmmmmmmmebme
drawMst	bmmebme
drawTimeBox	bmmebmmebme
drift_comp	bmmmerbmme
dsc_orientation	bmerbmmmmmmmmme
dst0.x	bmesrs
dst_buffer_to_hmac_md5	bmerbmmmmerberbmmerbes
dtstart.year	bmmmmmerbmme
dtype_form_prtype	bmmmerbmmerbmmmme
durations	bmmmmmmme
dv_init_dct248	berbmmerbmebme
dv_video_source	berbmmmerbmmmme
dwUpperLimit	bebmmmebmmme
dwUser	bebmme
dw_mode	berbmme
dwarf2out_return_reg	bmmmesbmerbmmmmerbme
dwl	bme
eCSSKeyword_scrollbartrack_vertical	sbmmmmmmmmerbmmmmmmmmmmmmerbmmmmmme
eOnDataAvail	sbebmmebmmme
eSendBehindFront	sbmmebmmmmebmmme
eStyleStruct_Max	sbmmmebmmmmerbme
eSystemFont_Tooltips	sbmmmmebmmerbmmmmmme
e__SystemEnumStrict_n_from_then_to_uts	srrbmmmmebmmebmmmmersrbmmerbmmerberbme
ectr	bmme
edu.colorado.phet.energyskatepark.view.piccolo.SkaterNode	bmerbmmmmmmerbmmerbmmmmmmmmmmmmmerbmmerbmmmmmerbmmmmebmme
eh_proto	berbmmme
emb_read_rows	bmerbmmerbmme
encodeDiv	bmmmmebme
encodeXMLWideFieldElement	bmmmmebmmmmmebmmmebmmmmme
endtravelflags	bmmmmmmmmmmmme
entry_ptr	bmmmerbme
env.width	bmerbmmme
eod	bme
eq_func	berbmme
equivs_.last	bmmmmerrbmme
errFileOpen	bmebmmebmme
error2ECD	bmmmesbme
errorWarning.filename	bmmmebmmmmmerbmmmmmme
error_mark_node	bmmmerbmmerbmme
evTimeRW	bebmmebe
ex_coeff_d	berbmmmers
exact_sos_count	bmmmerbmerbmmme
examples.jaxb	bmmmmmmerbmme
execCM_ADD	bmmeberbme
execDICTSTARTCONF	bmmebmmmmmmmmmmme
execDI_FCOUNTCONF	bmmeberbmmmmmmmme
execTUP_ALLOCREQ	bmmebmerbmmmmmme
execWAIT_DROP_TAB_REQ	bmmebmmerbmmerbmerbme
execute_ln	bmmmmmerbe
existingNode	bmmmmmmebmme
explodedDisplay	bmmmmmmebmmmmme
expn	bmme
exportPHYLIPINTERFile	bmmmmebmmmmmmmmmmmmme
extractClientEntriesFromUrl	bmmmmmebmmmmebmmmmmebmmebme
f__curunit	srrbmmmmme
f_bkpt	srbmme
fartherin	bmmmmmmme
fastmin	bmmmmme
faviconGeneratorElement	bmmmmmebmmmmmmmebmmmmme
fbuffer	bmmmmme
fc.privateContext	berbmmmmmebmmmmme
fcheckData.data	bmmmmebmmerbmme
fdlMeta.left	bmebmmerbmme
fdset	bmmme
ff_mpeg1_find_frame_end	berbmmesrbmmerbmmmerbme
ffebld_constant_realdefault	bmmmmerbmmmmmmerbmmmmmmmmme
ffeexprOperator_	bmmmmmebmmmmmmer
ffestp_file.type	bmmmmerbmmerbmme
ffetarget_offset_add	bmmmmmmmerbmmmmerbme
fftw_sem_post	bmmerbmerbmme
field_idx	bmmmerbme
filesort_limit	bmmmmmmerbmmme
fill_params	bmmerbmmmme
findHostHealths	bmmebmmebmmmmme
findSplitRTleaf	bmmebmmmebmmmme
first_resize_height	bmmmerbmmmmerbmmmme
flFlags	bebmmme
flag_schedule_insns	bmmerbmmmmmmerbmmme
fname.chars	bmmmerbmmme
fontAFM	bmmebme
fontColorLU	bmmebmmmebe
forceUnixStyle	bmmmebmmebmmme
format.mSystemId	bmmmmersbmmmmebe
foundDirID	bmmmebmebe
fpMediaInfo4_Info_Version	bebmmmebmmesrbmmerbmmmmme
fp_delete	berbmmmme
fpmp	bmme
fr.tm.elibel.smartqvt.qvt.imperativeocl.ImperativeExpression	berberbmmmmerbmmmmmmerbmerbmmmmmmmmmmmerbmmmmmmmmebmmmmmmmme
frame_num_offset	bmmmerbmerbmmmme
free_debug_proc	bmmerbmmmerbmme
fsControl	bebmmmmme
ft_cleanup_stack_done	berbmmmmmerbmmmerbmme
ftpAdapter	bmebmmmmme
fuUsage	bebmmme
fullurlC	bmmmmmes
func_items	bmmerbmmme
g640x480x16_regs	sbmesbmesberbmme
gCatInfoPB.hFileInfo.ioFlXFndrInfo	sbmebmmebersbmmebmmerbebebmmmebmme
gConstNoneCharSetMap	sbmmmebmmebmmebmebme
gOverlay.the_gui	sbmmmmmerbmerbme
gRootAtkObject	sbmmebmebmmmme
gU2Ntable	sssbmmmme
g_EUCTWShiftTableSet	srbmmmmmmmmebmmmebme
g_MacTurkishMappingTable	srbmebmmmmmebmmmmmebmmme
g_date_update_dmy	srbmmerbmmmmerbme
g_nVecVariableCount	srsbmebmmmmmmebmmme
g_node_new	srbmmerbme
g_return_if_fail	srbmmmmerberbmme
g_ufCP949NoKSCHangulMapping	srbebebmebebmmmmmmmebmmmmme
gcLocksHash	bebmmmebmme
gdk_draw_image	bmerbmmerbmmme
gdk_pixmap_create_from_xpm	bmerbmmmmerbmmmmerbmmerbme
gdk_x11_atom_to_xatom	bmersberbmmerberbmmme
ge.col_fuzzy	berbmerbmmme
gen_nonce_hash	bmerbmmmerbmme
gencache_iterate	bmmmmmmerbmmmmme
generateFrameFile	bmmmmmmebmmmebmme
generateShadowsToXML	bmmmmmmebmmmmmebebme
getAllByName	bmebmebebmme
getAssociatedJoinDeclares	bmebmmmmmmmmebmmebmmmmmme
getBusinessPClassDC	bmebmmmmmmebmmmmebe
getConfigurationDao	bmebmmmmmmmmmmmebme
getConfigurationDir	bmebmmmmmmmmmmmebme
getCopyCheckbox	bmebmmebmmmmmme
getDoubleObjectArray	bmebmmmmebmmmmebmmme
getEOLMarkers	bmebmmmmmmmme
getEn_db_id	bmeberberbe
getGLJournalID	bmebmmmmmmmebe
getIdxElt	bmebmebme
getImageFromPlugin	bmebmmmebmmebmmmme
getInvKindName	bmebmebmmebmme
getKindOfStockTransactionDC	bmebmmebebmmmebmmmmmmmmmebe
getLastAdmInDateGregorian	bmebmmebmebebmmebmmmmmmme
getLastNumReturnValues	bmebmmebmebmmmmebmmmme
getLastViewedSys	bmebmmebmmmmebme
getMBMessageService	bmebmmmmmmmebmmmmme
getMaxIn	bmebmebe
getNSMapping	bmebmmmmmmme
getNumeroFils	bmebmmmmebmme
getObsXCoord	bmebmebmmmme
getOfBOM	bmebebme
getPHPProjects	bmebmmmmmmmmme
getPrefString	bmebmmebmmmme
getStdInName	bmebmebebmme
getTblOverlap	bmebmebmmmmme
getTimersAsXml	bmebmmmmebebme
getUIRenderer	bmebmmmmmmmme
getVersionservidor	bmebmmmmmmmmmmmmme
getViolatedConstraints	bmebmmmmmmebmmmmmmmmme
get_address_gsl_matrix_long_double_max_index	bmerbmmmmmerbmerbmmmmerbmmerbmmmmerbmerbmmme
get_callerid_ast	bmerbmmmmmmerbme
get_toc	bmerbme
get_tsd	bmerbme
getcolor	bmmmmmme
getservbyname	bmmmmmmmmmmme
getterAtom	bmmmmebmme
gmlltmp	bmmmmme
gov.usda.gdpc.GenotypeExperimentProperty	bmerbmmerbmmerbmmmmmmebmmmmmmmmebmmmmmme
gram_vsa	bmmerbme
greenRGB	bmmmebme
grid.xaxis.circular.hmt	bmmerbmmmerbmmmmmmerbme
gridBagConstraintsX.gridx	bmmebmebmmmmmmmmmesrbmmme
gs_malloc	berbmmmme
gtk_widget_ensure_style	bmerbmmmmerbmmmmerbmmme
gx_remap_concrete_gray	berbmmmerbmmmmmmerbmme
gz_compress_mmap	berbmmmmmmerbmme
h263_chroma_roundtab	sbmerbmmmmerbmmmmmme
handle_channelstatus	bmmmmerbmmmmmmmmmmme
hbit	bmme
headExp	bmmebme
help_dimu	bmmerbmme
hiddenXMax	bmmmmebmme
highestX	bmmmmmes
hisip	bmmme
hit.linkcount	bmerbmmmmmmme
hlib	bmme
hookGraphicalViewer	bmmebmmmmmmmebmmmme
horzVis	bmmebme
hpb.ioDirID	bmerbebmebe
hpcxs	bmmme
htdbm_init	bmmmerbmme
html40Latin1	bmmebebmmmes
hval	bmme
hwndCancel	bmmebmmmme
i.lvals	srbmmme
iCCP_TYPE	sbmerbmme
iMin	sbme
iTermcond	sbmmmmmme
i_qp0_cost2_table	srbesrbmmesrbmmme
icause	bmmmme
icmLuMonoFwd_map	bmebebmmebmerbme
icmTextDescription_get_size	bmebmmebmmmmmmmmmerbmerbmme
iconLense	bmmebmmme
iconv_close	bmmmerbmmme
id_clash_len	berbmmmerbme
idct_cosine_table	bmmerbmmmmerbmmme
idmlinitiative.resources.dtds.aida22.impl.IDTypeImpl.Unmarshaller	bmmmmmmmmmmmmerbmmmmmmmerbmmerbmmeberbmmerbmmmmebmmerbmmmmmmmmmme
iff	bme
ijintArrayame	bmmmebmmmmmme
illegalNums	bmmmmmebmme
imgHeight	bmebmmmme
inFERange	bebmmmmme
inPathLen	bebmmebme
in_conns.remove	berbmmmerbmmmme
includedTocFile	bmmmmmmebmebmme
includes_AST_in	bmmmmmmerbmerbe
indFullresPath	bmebmmmmmebmme
indexOpId	bmmmebebe
index_rtx	bmmmerbme
info.magnolia.cms.beans.runtime.Document	bmmerbmmmmmmerbmerbmmmerbmmmmmerbmmmmmme
initDBWishlists	bmmebmmmmmmmmme
initImageBuffer	bmmebmmmebmmmme
init_g16_i	bmmersbers
init_outer_loop	bmmerbmmmerbmme
init_q_auth_2	bmmersrbmmers
init_reg_q_close	bmmerbmersrbmmme
initarea	bmmmmmme
initialClearApars	bmmmmmebmmmebmmme
initialConnectionSql	bmmmmmebmmmmmmmmebme
interdata	bmmmmmmme
intra_only	bmmmerbmme
ioBuffer	bebmmmme
ipcServiceConstructor	bmebmmmmmebmmmmmmmmme
ipchat.info.infoFrame	bmmmmerbmmerbmmebmmme
iquant_intra_m2	bmmmmerbmmmerss
irpd_getservbyname	bmmerbmmmmmmmmmmme
isIgnoreLoginState	bebmmmmebmmmebmmme
isMaxnumingroupModified	bebmmmmmmmmmmmebmmmmmme
isapi_lookup	bmmmerbmmmme
isaplot	bmmmmme
isldvowel	bmmmmmmme
issuerSHA1KeyHash.len	bmmmmebmesbmebmmerbme
iswrite	bmmmmme
it.tidalwave.bluemarine.text.APEXApertureFormat	berbmmmmmmmerbmmmmmmmmerbmmerbmmmmmmmmmmebmmmme
itemLast	bmmebmme
itemnr	bmmmme
jace.proxygen	bmmerbmmmmmme
jadEncoding	bmebmmmmmme
java_class_or_instance	bmmerbmmmerberbmmmmmme
javax.management.remote.rmi	bmmmerbmmmmmmmmerbmmmmerbme
jdoBeforeUpdate	bmebmmmmebmmmme
jmi_wreset	bmerbmmmme
jpegTags	bmmebmme
jpeg_consume_input	bmmerbmmmmmerbmmme
jrenderer	bmmmmmmme
jsTypeTags_	bebmmebmmer
js_Invoke	berbmmmme
jsd_IsValuePrimitive	bmerbebmmmebmmmmmmme
jserv_pool	bmmmerbmme
jsoSourceFolder	bmebmmmmebmmmme
jsystray	bmmmmmme
jwo	bme
kBoPoMoFoOrderIdCID	sbebebebebmmmebebme
kCurrentCWPanelListVersion	sbmmmmmebmmmmmebmmebmmmmme
kDOMImplementationCID	sbmmmmmmmmmmmmmmmebme
kFirstDirSize	sbmmmebmebmme
kIDataFlavor	sbmmmebmmmme
kInitSavePageDelay	sbmmebmmebmmebmmme
kInputStreamChannelCID	sbmmmebmmmmebmmmmmebme
kMsgAccountManagerCID	sbmebmmmmmebmmmmmebme
kNC_Description	sberbmmmmmmmmme
kSqrChar	sbmebmme
kTelugu	sbmmmme
kaboom	bmmmme
keaParams.originatorKEAKey.len	bmebmmmmerbmmmmmmmmebmmmmerbme
key_derive	bmerbmmmme
keysToDelete	bmmebebmmmme
keytext	bmmmmme
kmap	bmme
lad_fs.total	bmerberbmmme
langKannada	bmmebmmmmme
langTagalog	bmmebmmmmme
lang_list	bmmerbmme
lastStartPosMatch	bmmebmmmebmebmmme
lastTimeTick	bmmebmmebmme
lblCounter	bmebmmmmme
lcpFragmentId	bmebmmmmmmebe
lcpPtr.i	bmebmers
ldap_err2string	bmmerbmesbmmmme
leitchdev	bmmmmmmme
lft_rb	bmerbe
libjava	bmmmmme
linktooltip	bmmmmmmmmme
lis	bme
lister_print_horizontal	bmmmmerbmmmerbmmmmmmmme
localQDefaultTriggerMsgPriority	bmmmebmmmmmmebmmmmmebmebmmmmmme
local_freed_mem	bmmmerbmmmerbme
logBlendFunc	bmebmmmebmme
loginTabPane	bmmmebmebmme
logval_status	bmmmmerbmmmme
loopinfo	bmmmmmme
lowbits	bmmmmme
lpc10.dec	bmeberbme
lsa_io_r_lookup_names	bmerbersrbmmmmerbmmme
lsa_io_r_query_info2	bmerbersrbmmmerbmmes
lum_green_weight	bmerbmmmerbmmmme
lunch_defendj	bmmmerbmmmmme
mBackgroundYPosition	sbmmmmmmmmebmmmmmmme
mComputedMinWidth	sbmmmmmmebmebmmme
mDefaultNamespaceID	sbmmmmmebmmmmmmmebe
mDeque.mSize	sbmmmersbmme
mHTMLBindingStr	sbmmmmmmmmmebme
mLenBuf	sbmebme
mMozAreaClosestParent	sbmebmmebmmmmmebmmmme
mMozWindowWidget	sbmebmmmmebmmmme
mNKeys	sbmmme
mNumItems	sbmebmmme
mPACURL	sbmmmme
mPath.mLen	sbmmersbme
mPropertyCount	sbmmmmmmebmmme
mReqUploadStreamLength	sbmebmmmmebmmmmebmmmme
mSpec.vRefNum	sbmmersbmebme
mStartCData	sbmmmebmmme
mSubType	sbmebmme
mTargetSpec.vRefNum	sbmmmmebmmersbmebme
mWyciwygChannel	sbmmmmmebmmmmme
m_MarginHeaderFooterTab.m_HeaderRightText	srbmmmmebmmmmebmmmmebmersrbmmmmebmmmebmme
m_ToolTip.m_hWnd	srbmmebmersrsbme
m_bGPLEvildoer	srsbmmmmmmmmme
m_bircsoundevents	srbmmmmmmmmmmmmme
m_charCommonMax	srbmmebmmmmebme
m_crSelectedTextColor	srbebmmmmmmebmmebmmme
m_csBtn1Text	srbebmesbmme
m_ctrlUpdateServerFrm	srbmmebmmmmebmmmmebme
m_firstExecutedScanOp	srbmmmebmmmmmmebmmebe
m_iMaxChatHistory	srsbmebmmebmmmmme
m_iSentMoreReq	srsbmmebmmebme
m_mozstatus	srbmmmmmmme
m_namespaceSupport	srbmmmmmmmebmmmmme
m_nsCard	srbebmme
m_originalPhysicalUri	srbmmmmmmebmmmmmmebme
m_pfn_qglCallLists	srbmerbmebmmebmmme
m_pfn_qglTexCoord2f	srbmerbmebmebmmmess
m_pk2len	srbesbme
m_preSetItem	srbmebmebmme
m_sLDAPSearchBase	srsbmmmmmmmmebmme
m_sizeHdrImgListIcon.cy	srbmmebmebmebmmebmmerbe
m_strHost	srbmebmme
m_wndEvents	srbmebmmmme
mac_error	bmerbmmme
makeConnectString	bmmebmmmmmebmmmme
makeSvgFile	bmmebmebmme
make_const_array	bmmerbmmmerbmmme
mapFriend	bmebmmmme
mappedUiString.autoSurround	bmmmmebebmmmmerbmmebmmmmmme
marshalledRegs	bmmmmmmmmebmme
mask.ccolor.pattern	bmmerbmmmmerbmmmmme
max.setLongValue	bmerbmebmmebmmme
maxLeafToRootPath	bmebmmebebmmebmme
max_label	bmerbmmme
max_portals	bmerbmmmmme
maxdy	bmmme
maybe_cc0_setter	bmmmerbesrbmmmme
maybepermanent_obstack	bmmmmmmmmmmmmerbmmmmme
md.waiter_sem	berbmmmmerbme
mdef.operation	bmmerbmmmmmmme
mdia.minf.stbl.stsz.sample_size	bmmerbmmerbmmerbmmerbmmmmerbmme
mec.dwSampleRate	bmerbebmmmmebmme
mechanism.ulParameterLen	bmmmmmmmerbebmmmmmmmebme
memPercent	bmebmmmmme
menu_open_new_cb	bmmerbmmerbmerbe
menuitem	bmmmmmme
messageCtchar.getValueLength	bmmmmmebmmmmerbmebmmmebmmmme
metaKeyArg	bmmebmebme
mgcp_reload	bmmerbmmmme
mgr_next_row	bmerbmmerbme
minResidualCapacity	bmebmmmmmmebmmmmmme
minplayers	bmmmmmmmme
mixmonitor_flags	bmmmmmmmmerbmmme
mng_ani_trnsp	bmerbmerbmmme
mng_display_rgb8_a8	bmerbmmmmmerbmesrss
mng_magnify_y	bmerbmmmmmers
mng_processsave	bmerbmmmmmmmmme
mng_store_jpeg_ga8	bmerbmmmerbmmerbes
mod.mod_op	bmerbmerbe
moduleDir	bmmmmebme
morkCh_kN	bmmeberss
morkMagic_kThumb	bmmebmmmersbmmme
morseCoder	bmmmebmmme
mp4ff_get_track_type	besberbmerbmmmerbmme
mpeg3_aa_cs	bmmesrberbe
mpeg3demux_movie_size	bmmesbmmmerbmmmerbmme
mpeg_quant	bmmerbmmme
mpegts_demux	bmmmmerbmmme
mprLogPagePtr	bmebmebmmebme
mq_mess.PROC_NR	berbmmerbmmerbe
msgChunk	bmebmmme
msgIsInLocalCache	bmebebebmmmebmmme
msgwin	bmmmme
mtcm	bmme
mutation.mAttrName	bmmmmmmersbmmebmme
myDialog.m_flagvalue	bebmmmmersrbmmmmmmme
myPDayAL	bebmmebe
mysql_kill	bmmmerbmme
naarani.Design.Table	bmmmmmerbmmmmerbmmme
nativeFolderName	bmmmmebmmmmebmme
naturalLogBase	bmmmmmebmebmme
nbrTableCols	bmebmmmebmme
ndbcluster_find_files	bmmmmmmmmerbmmerbmmme
negative_ok	bmmmmmmerbe
net.matuschek.util.ByteBuffer	bmerbmmmmmmmerbmmerbmmebmmmme
net.sf.fixtag.app	bmerberbmmmmerbme
net.sourceforge.barbecue.env.HeadlessEnvironment	bmerbmmmmmmmmmerbmmmmmmerbmerbmmmmmmebmmmmmmmmme
net.sourceforge.island.authentication.AuthenticationException	bmerbmmmmmmmmmerbmmmmerbmmmmmmmmmmmmerbmmmmmmmmmmmmebmmmmmmme
net.sourceforge.jt673.joules	bmerbmmmmmmmmmerbebmerbmmmme
net.sourceforge.ojb2hbm.OJB2Hbm	bmerbmmmmmmmmmerbmesbmerbmesbme
networkOptionsInfo.display.string	bmmmmmebmmmmmebmmerbmmmmmerbmmmme
newChemBond	bmebmmebmme
newCirc	bmebmme
newExtnValue	bmebmmebmmme
newInsertPosRect	bmebmmmmebmebmme
newStreamFilterAction	bmebmmmmebmmmmebmmmme
newlnf	bmmmme
nextProcessPsn.lowLongOfPSN	bmmebmmmmmebmerbmebmmebebme
nextfield	bmmmmmmme
nextfreeoverrec	bmmmmmmmmmmmmme
nfCompRep	bebmmebme
nmemb	bmmme
nodestateUnits.addElement	bmmmmmmmebmmmerbmebmmmmme
nodevalues	bmmmmmmmme
notQButton	bmebmmmmme
npos	bmme
nr_AppendDesc	berbmmmmebmme
nsAString::char_type	bebmmmmmessbmmerbmme
nsCSSValueListSH	bebmmmmmmebmmebe
nsCaseConversionImp2	bebmmebmmmmmmmmebmes
nsCopyFileMessageType	bebmmebmmebmmmmmebmme
nsDOMEventGroup	bebmmmmmmebmmme
nsDeviceContextSpecFactoryMac	bebmmmmebmmmmmebmmebmmmmmebme
nsDocumentType	bebmmmmmmebmme
nsDrawingSurfacePh	bebmmmmmebmmmmmebe
nsFontGTKUserDefined	bebmmebmmmmmebmmmmme
nsHTMLOListElement	bebmmmmmmmebmmmmme
nsIAbView	bebmebmme
nsIAboutModule	bebmmmmebmmmme
nsILocaleFactory	bebmmmmmebmmmmme
nsINativeComponentLoader	bebmmmmmebmmmmmmmebmmmme
nsIXPTLoader	bebmmmmmmmme
nsImapOfflineToOnlineCopy	bebmmebmmmmmebebmmmmebmme
nsKeyPairInfoStr	bebmebmmebmmebme
nsLDAPSSLConnect	bebmmmmmmmmmmmme
nsMathMLmoverFrame	bebmmebmmmmmebmmme
nsMdbTableEnumerator	bebmebmmmebmmmmmmmme
nsMouseMove	bebmmmebmme
nsMsgAccountManagerDataSource	bebmebmmmmmebmmmmmebmmebmmmme
nsPasteNoFormattingCommand	bebmmmebebmmmmmmmmebmmmmme
nsSOCKSIOLayerAcceptRead	bebmmmmmmmmmmebmmmmebmme
nsSelectionCommandsBase	bebmmmmmmmebmmmmmmebmme
nsSharableString::shared_buffer_handle_type	bebmmmmmmebmmmmessbmmmmerbmmmmerbmmmmerbmme
nsSingleSignOnProfileObserver	bebmmmmebmmebebmmmmmebmmmmmme
nsUnicharStreamLoader	bebmmmmmebmmmmebmmmme
nsUnicodeToBIG5HKSCSConstructor	bebmmmmmebebmesbmmmmmmmmmmmmmme
nsUnicodeToBIG5NoAscii	bebmmmmmebebmesbebmmme
nsVoidBTree::Path	bebmmebmmmessbmme
nsXULTabAccessible	bebmmmmebmmmmmmmme
nsldapi_close_connection	bmmmmmerbmmmerbmmmmmmmme
nsocks	bmmmme
nss	bme
nssCryptoContext_FindCertificatesBySubject	bmebmmmmebmmmmmerbmmebmmmmmmmmmmebebmmmmme
nssPKIXAttribute_SetType	bmebmmmmmmmmmmmerbmebmme
ntriangoli	bmmmmmmmme
ntv	bme
numOfRootChoreos	bmebebmmebmmmmme
numTargetTables	bmebmmmmebmmmme
num_deaths	bmerbmmmme
num_fixed_sizes	bmerbmmmerbmmme
num_syncword	bmerbmmmmmme
o.f_stringarray	srsrbmmmmmmmmme
oDontFeedMe	sbmmebmmebe
oWPUB	sbmme
objectcontact	bmmmmmmmmmmme
obproxyfound	bmmmmmmmmmme
og.header	berbmmmme
ogg_iformat	bmerbmmmmme
oldMsgId	bmebmebe
oldPosOnCurrentLine	bmebmebebmmmmmebmme
oldTrashNameUtf7	bmebmmmebmmebmes
oldportal.objectbuilder.document.cpp.editors.ClassMethodPanel	bmmmmmmmerbmmmmmmmmmmmerbmmmmmmerbmerbmmmmmerbmmmebmmmmebmmme
omodes	bmmmme
one_fn	bmerbe
opArguments	bebmmmmmmme
opLocalClock	bebmmmebmmme
opcode_function_new	bmmmmerbmmmmmmerbme
openb	bmmme
openwfe.org.net	bmmmmmerbmerbme
opt_BinaryDER	bmerbmmmmebme
ordre.forcePropulseurArriere	bmmmerbmmmebmmmmmmmmebmmmmme
oreq	bmme
orfs	bmme
org.amberarcher.os	bmerbmmmmmmmmmerbe
org.apache.poi.hssf.usermodel.TestCellStyle	bmerbmmmmerbmerbmmerbmmmmmmmerbmmebmmebmmme
org.apache.slide.common.ServiceAccessException	bmerbmmmmerbmmmerbmmmmerbmmmmmebmmmmebmmmmmmme
org.apache.tools.ant.taskdefs.condition.Http	bmerbmmmmerbmmmerbmerbmmmmmmerbmmmmmmmerbmme
org.apache.turbine.flux.modules.actions.group	bmerbmmmmerbmmmmmerbmmerbmmmmmerbmmmmmerbmmme
org.bouncycastle.asn1.DERBoolean	bmerbmmmmmmmmmmerbmesrbmmmmmmmme
org.bouncycastle.crypto.engines.NullEngine	bmerbmmmmmmmmmmerbmmmmerbmmmmmerbmmebmmmme
org.bouncycastle.jce.cert.PKIXCertPathValidatorResult	bmerbmmmmmmmmmmerbmerbmmerbmmmmmmebmmebmmmmmmmebmmmme
org.centricware.storage.controller.guide.MenuController	bmerbmmmmmmmmmerbmmmmmerbmmmmmmmmerbmmmerbmmebmmmmmmmme
org.columba.calendar.config.api.ICalendarList	bmerbmmmmmerbmmmmmmerbmmmmerbmerbmmmmmmmebmme
org.dancres.blitz.remote.debug	bmerbmmmmmerbmmmerbmmmmerbmmme
org.dellroad.jc.cgen.analysis	bmerbmmmmmmerberbmmerbmmmmmme
org.eclipse.jdt.core.IParent	bmerbmmmmmerbmerbmmerbmmmmme
org.emulinker.kaillera.pico	bmerbmmmmmmmerbmmmmmmerbmme
org.htmlencoder.factory	bmerbmmmmmmmmmerbmmmmme
org.hyperic.hq.auth	bmerbmmmmmerberbmme
org.imemex.componentmappings.content.fsreplica	bmerbmmmmerbmmmmmmmmmmmmmmmerbmmmmmerbmmmmmmme
org.jamocha.gui.tab.FunctionsPanel	bmerbmmmmmerbmerbmerbmmmmmmmebmmme
org.jboss.virtual.plugins.vfs.helpers.SuffixesExcludeFilter	bmerbmmmerbmmmmmerbmmmmmerbmerbmmmmmerbmmmmmmebmmmmmebmmmme
org.jfree.util.SortOrder	bmerbmmmerbmmerbmmebmmme
org.jruby.lexer.yacc.SourcePosition	bmerbmmmerbmmmerbmmerbmmmmebmmmmmme
org.jsecurity.context.factory.SecurityContextFactory	bmerbmmmmmmmerbmmmmmerbmmmmmerbmmmmmmebmmmmmebmmmmme
org.jvnet.jaxb.reflection.model.runtime.RuntimeTypeInfoSet	bmerbmmmerbmmerbmmmmmmmmerbmmmerbmmmmmerbmmmmmebmmebmmebme
org.ksmsa.richDoc.bibliography.types.BibType	bmerbmmmerbmmebmerbmmmmmmmmmmerbmmmerbmebmme
org.mimosa.www.TechXMLV3_1.mim_5001_05.CharYN	bmerbmmmmerbmerbmmebmmesrsrbmerbmmerberbmmebe
org.opengroupware.jogi.connect.Connection	bmerbmmmmmmmmmmmerbmmerbmmmmmerbmmmmmmmme
org.ourgrid.gridmachine.exception.UnableToExecuteException	bmerbmmmmmerbmmmmmmmmmerbmmmmmmmerbmmmmebebmmmmmebmmmmmmme
org.outerj.daisy.doctaskrunner.clientimpl	bmerbmmmmerbmmmerbmmmmmmmmmmmerbmmmmmmmme
org.pi4soa.designer.types.figures.SimpleTypeFigure	bmerbesbmerbmmmmmmerbmmmerbmmmmmerbmmmmebmmebmmmme
org.pi4soa.service.DefaultIdentity	bmerbesbmerbmmmmmerbmmmmmebmmmmmme
org.schmant.report.StdoutReportFactory	bmerbmmmmmerbmmmmerbmmmmebmmmmebmmmmme
org.springframework.web.context.support.ServletContextResourceLoader	bmerbmmmmmmmmmmmmmerbmerbmmmmmerbmmmmmerbmmmmmebmmmmmebmmmmmmebmmmme
org.touchupweb.system.UpdaterLauncher	bmerbmmmmmmmmerbmmmmerbmmmmmebmmmmmme
org.umber.bellows.IDatumTransformer	bmerbmmmerbmmmmmerbmmmmebmmmmmmmmme
org.xmlcrawler.iquery.QueryStructure	bmerbmmmmmmmmerbmmmmerbmmmebmmmmmmme
orgLineColor	bmebmmebmmme
origArtOId	bmmebmebme
orig_to	bmmerbe
originalVartype	bmmmmmmebmmmmme
os2.usWidthClass	besrbebmmmebmmme
os_file_closedir	berbmmerbmmmmmme
osmsDvAlgorithmManager	bmmebebmmmmmmmebmmmmme
other_expr	bmmmerbmme
outBuf.mBuf_Fill	bmebmersbmerbmme
outIfaceFuncImpl	bmebmmmebmmebmme
out_isatty	bmerbmmmme
out_left_diff	bmerbmmerbmme
outcur	bmmmme
outpos	bmmmme
outputOrgs	bmmmmebmme
ovalrect_node	bmmmmmmerbmme
p2absln	ssbmmme
pIDispParent	sbmmmebmmmme
pOdDescrProperty	sbebmmmebmmmmmme
p_cmdNumber	srbmebmmmme
pac_io_krb_attrs	bmerberbmerbmmme
pango_coverage_new	bmmmerbmmmmmmerbme
paper_width_in_twips	bmmmerbmmmerberbmmme
param.res_length	bmmmerbmerbmmmme
param.tmpdir	bmmmerbmmmme
paramOrdinal	bmmmebmmmmme
paramParseFile	bmmmebmmmebmme
param_usage	bmmmerbmmme
params.CalGrayProfile	bmmmmerbmebmmebmmmmme
params.def	bmmmmerbme
parseDefLine	bmmmebmebmme
parseDocumentElement	bmmmebmmmmmmebmmmmme
parseIntArrayToString	bmmmebmebmmmebebmmmme
partOutLen	bmmebmebme
passoL	bmmmes
passwordTemplate	bmmmmmmebmmmmmme
pcmret	bmmmme
pcr	bme
pdf14_mark_procs	bmeberbmmerbmmme
pdf_font_descriptor_values_t	bmerbmmerbmmmmmmmmerbmmmmers
pharerouge.utils.InterruptableInputStream	bmmmmmmmmerbmmmerbmmmmmmmmmmmebmmmebmmmme
phex.xml.sax.DElement	bmmerbmerbmerbmmmmmme
pixbufLock	bmmmmebmme
pn_max	berbme
pnlEsEcl_btnOutDir.setEnabled	bmebebmerbmebmebmerbmebmmmmme
portTypeNamespace	bmmebmmebmmmmmmme
prFileNo	bebmmebe
pr_previous	berbmmmmmme
prec_sym_name.value	bmmerbmerbmmerbmmme
pred_ctime	bmmerbmmme
predict_16x16_dc_top	bmmmmmerbesberberbme
prefColorTree	bmmebmmmebmme
pref_saveArgs	bmmerbmmebmme
prefsData.verbose	bmmmebmmerbmmmmme
presentationFacade	bmmmmmmmmmmebmmmme
prevDescent	bmmebmmmmme
prevGcpConnect	bmmebmebmmmmme
prev_pos	bmmerbme
previous_ch	bmmmmmmerbe
primary_gid	bmmmmmerbme
printDROP_TRIG_CONF	bmmmebmmerbmmerbmme
printPreBlockExpression	bmmmebmebmmmebmmmmmmmme
print_ident_comments	bmmmerbmmmerbmmmmmme
print_unexp	bmmmerbmmme
printdir	bmmmmmme
process_nmb_request	bmmmmmerbmerbmmmmme
procnames_start_line	bmmmmmmmerbmmmerbmme
productUPDATESQL	bmmmmmebmmmmmmme
profDebutPlage	bmmebmmmebmmme
psFGList	bebmmmme
psf_get_filelen_fd	bmerbmerbmmmmmerbe
psname	bmmmme
pstoreDir	bmmmmebme
ptr_passwd	bmerbmmmme
publicationUrl	bmmmmmmmmmebme
pusWrappedKeyLen	bmebmmmmmebmebme
pwce	bmme
q1_numfaces	ssrbmmmmmme
qe.last_pos_said	berbmmerbmerbmme
qglMapGrid2f	bmebmebmmess
qglTexGenfv	bmebmebmmme
qpix_avg	bmmerbme
query_md_blob_data_req	bmmmerberbmmerbmmerbme
questKill	bmmmebmme
quicktime_edts_t	bmmmmmmmerbmmers
quicktime_flush_vcodec	bmmmmmmmerbmmmerbmmmme
rCombo.bottom	sbmmmerbmmmme
randHash	bmmebmme
randomNumberGen	bmmmmebmmmmebme
rcchk_	bmmmer
rcverHostName	bmmmebmmebmme
readExecSrNewMbyte	bmmebmmebebmebmmme
readVCM	bmmebme
reads_colormodel	bmmmerbmmmmmmmme
realURI	bmmebme
recordingfilename	bmmmmmmmmmmmmmmme
recursiveNodeTraversal	bmmmmmmmebmmebmmmmmmme
recv_max_parsed_page_no	bmmerbmerbmmmmerbmmerbe
redirectParent	bmmmmmmebmmmme
redirectorType	bmmmmmmmmebmme
refHdr	bmebme
refQueueInfo	bmebmmmebmme
reflowReasonString	bmmmmebmmmmebmmmme
refreshFavouritesList	bmmmmmebmmmmmmmmebmme
reg.i_key_boost	bmersrbmerbmmme
reg_set_table_size	bmerbmerbmmmerbmme
register_agent	bmmmmmmerbmmme
regmove_time	bmmmmmerbmme
reloadreg	bmmmmmmme
remote_playlist_delete	bmmmmerbmmmmmmerbmmmme
removeBotsMenuInfo.up.width	bmmmmebmmebmmebmmerberbmmme
resolution_opt	bmmmmmmmmerbme
ret_sub	bmerbme
retco	bmmme
rev_increment	bmerbmmmmmmme
rgTop	bebme
rgb4	bmes
rhs.mStartPageNum	bmersbmmmebmmebme
rightFreedom	bmmmebmmmmme
rightPos	bmmmebme
rl_editing_mode	berbmmmmmerbmme
roid	bmme
rowCopyLen	bmebmmebme
row_upd_rec_sys_fields_in_recovery	bmerbmerbmerbmerbmmmmerberbmmmmmme
rstrmbuf	bmmmmmme
rtlname	bmmmmme
run_eol_code_value	bmerbmerbmmerbmmme
runiqueId	bmmmmmebe
rw_case	berbmme
s3mrtgspeed	ssbmmmmmmme
sBeginLineString	sbmmmebmmebmmmme
sDB_COLUMN	sberbmmmme
sHTMLTagUnicodeName_img	sbmmmmmebmmmmmebmmerbme
sOS_DriveDirectory	sberbmmmebmmmmmmme
sUint16Val	sbmmebebme
s_options.sound.style	srbmmmmmerbmmmerbmmme
s_playersettings.banner.generic.y	srbmmmmmmmmmmmmerbmmmmerbmmmmmers
s_signup.password.generic.type	srbmmmmerbmmmmmmerbmmmmmerbmme
saga.inout.creation.CreationHandlerImpl	bmmerbmmmerbmmmmmmerbmmmmmmebmmmmmebmme
sampfmt	bmmmmme
sampy	bmmme
sandcx	bmmmme
saveConfigActionPerformed	bmmebmmmmebmmmmebmmmmmmme
saveXTFRInfo	bmmebmmmmmme
sball	bmmme
scalar12_float32_3DNow	bmmmmeberbmmmebersbmme
scanKeyinfoFlag	bmmebmmmmmebmme
scanLocalref	bmmebmmmmmme
scattoAllaRisposta	bmmmmebmmebmmmmmme
sd.signatureAlgorithm	berbmmmmmmmebmmmmmmme
searchInfo1.hFileInfo.ioFlFndrInfo.fdLocation.h	bmmmmebmmesrsbmmebmmerbebebmmebmmerbebmmmmmmers
sec_desc_size	bmerbmmerbmme
sec_pkcs12_destroy_certificate_list	bmerbmmeberbmmmmmerbmmmmmmmmmerbmme
secmodSlotDataStr	bmmmmebmmebmmebme
secrets_store_ldap_pw	bmmmmmerbmmmerbmmerbe
sect.sct_loyal	bmmerbmerbmmme
sect_amt	bmmerbme
sendNdbSttor	bmmebmebmmme
servermajorversion	bmmmmmmmmmmmmmmmme
serverport	bmmmmmmmme
serviceNameQName	bmmmmmebmmebmmme
service_deregister	bmmmmmerbmmmmmmmme
setActiveTarget	bmebmmmmebmmmme
setAffichageSide	bmebmmmmmmmebmme
setAfficheDebFin	bmebmmmmmebmebme
setDisplayPicutre	bmebmmmmmebmmmmme
setDontBalanceTextColumns	bmebmmebmmmmmebmmebmmmmme
setGCtrl	bmebmmme
setImageResize	bmebmmmebmmmme
setInternalLoc	bmebmmmmmmebme
setMemberFirstIP	bmebmmmmebmmmebe
setPaginableFind	bmebmmmmmmmebmme
setRsrc_Name	bmebmmerbmme
setRunAttributesCB	bmebmebmmmmmmmmebe
setTopLevelGroupCRID	bmebmebmmmebmmmebmme
setYAxisLabelsPos	bmebmmmebmmmmebme
set_io	bmerbe
sfString.s	bebmmmmers
sfcadj	bmmmme
sfsbhome	bmmmmmme
sha_inner	bmerbmmme
shared_memory_pos	bmmmmerbmmmmerbme
ship.shp_y	bmmerbmers
should	bmmmme
si_DoDialogIfPrefIsOff	berbebmmmmebebmmebebme
sig_table_nelts	bmerbmmmerbmmme
sincos_bf	bmmmmerbe
size2.cx	bmmesrbe
skel_sys_acl_get_perm	bmmerbmerbmerbmerbmme
skip_bottom	bmmerbmmmme
slin_g723_ex	bmmersbmerbe
smbw_shared_fd	bmmerbmmmmerbe
smilehouse.opensyncro.pipes.component.DestinationIF	bmmmmmmmmerbmmmmmmmmerbmmmerbmmmmmmmerbmmmmmmmmmebe
sndCall.addr.maxlen	bmebmmerbmmerbmmmme
snd_ctl_elem_info_get_numid	bmerbmerbmmerbmmerbmerbmmme
snd_interval_t	bmerbmmmmmmers
snd_mixer_selem_set_capture_volume_range	bmerbmmmerbmmmerbmerbmmmmmerbmmmmerbmmme
snd_pcm_route_ttable_entry_t	bmerbmerbmmmerbmmmmerbmmmers
snd_seq_queue_timer_t	bmerbmerbmmmerbmmmers
snlimit	bmmmmme
sock_info.remote	bmmerbmmerbmmmme
spDocHostUIHandler	bebmebmmebmmmmmmme
spawn_init	bmmmerbmme
splitToIntArray	bmmmebebmebmmme
sqlOrderByClause	bmebmmmebebmmmme
srcPix	bmebme
ss.g_idx	bersrbme
ssl_InitGather	bmerbmmebmmmme
ssl_socket_sendv	bmerbmmmmerbmmme
startPoint.y	bmmmebmmmers
startSimulationUpdate	bmmmebmmmmmmmmebmmmme
stgmedData	bmmmmebmme
stockHeight	bmmmebmmmme
stopMbyte	bmmebmmme
strIDError	bmebmmmmme
strPoint	bmebmmme
str_AboutNMinutes	bmerbmmmebmmmmmme
stream_hc_state	bmmmmerberbmmme
styleSheetFactory	bmmmebmmmebmmmmme
svr.peer	bmerbmme
swf_write_trailer	bmerbmmmerbmmmmme
swingActions.LAF	bmmmebmmmmmerbme
swpOK	bmebe
synced	bmmmme
sys_trust_routine_creators	bmerbmmmerbmmmmmerbmmmmmme
tabSuperProfiles	bmebmmmebmmmmmme
tc_ett	berbme
tc_log	berbme
tcl_LogGet	bmerbmebme
tcp_print_conn	bmerbmmmerbmme
teardownReports.toArray	bmmmmmmebmmmmmerbebmmme
tech_log_base	bmmerbmerbmme
tensor_obounds	bmmmmerbmmmmme
term_mm	bmmerbe
terraindata.headerinfo.MinimumAltitude	bmmmmmmmmmerbmmmmmmmmerbmmmmmebmmmmmme
testAverageDistancesOnFfiniteDiameterGraph	bmmebmmmmmebmmmmmmmebebmmmmmebmmmmmmebmmme
testEnterJTableHeaderDragAndLeaveByPercentage	bmmebmmmebmmmmebmmmmebmmebmebmmmebebmmmmmmmme
testHeightOffsetWGS72	bmmebmmmmebmmmmebmebe
testIsAnnotation	bmmebebmmmmmmmme
testLoadClassesFromClasspathSorted	bmmebmmebmmmmmebmmebmmmmmmmebmmmme
testMetaDataDOM	bmmebmmebmmebme
testRmiProxyFactoryBeanWithConnectIOException	bmmebmebmmmebmmmmmebmmebmmebmmmmmebmmmmmmmmme
testSJISEncoder	bmmebmmmmmmmmme
testSimple7b	bmmebmmmmess
testWriteFloat	bmmebmmmebmmme
tests.basic.ResultSetTypesTests.suite	bmmmerbmmmerbmmmmebmebmmmebmmmerbmmme
textnode	bmmmmmme
textoSuperior	bmmmebmmmmmme
tfact	bmmme
tftpfolderField	bmmmmmmmmebmmme
tgeLocked	bmebmmmme
tgseElementptr	bmmebmmmmmmmme
that.global_block_size	bmmerbmmmmerbmmmerbmme
theDeathDB.updateFidByPtid	bmebmmmeberbmmmmebmebebmme
theImpl	bmebmme
theend	bmmmme
theframed	bmmmmmmme
themepackLabel	bmmmmmmmebmmme
this.GL_ARB_point_parameters	bmmerberbmerbmmmerbmmmmmmmme
this.allterms_hash	bmmerbmmmmmmerbmme
this.cbSize.setSelectedIndex	bmmerbebmmerbmebmmmmmmebmmme
this.checkboxArticle	bmmerbmmmmmmebmmmmme
this.cmd_id	bmmerbmerbe
this.docLangId	bmmerbmebmmebe
this.gcb	bmmerbme
this.loginExisted	bmmerbmmmebmmmmme
this.maxNumberOfGameConnections	bmmerbmebmmmmebebmmebmmmmmmmmme
this.metaTable	bmmerbmmebmmme
this.referencedObjectTimestampMap	bmmerbmmmmmmmmebmmmmebmmmmmmmebme
this.txtPatientNumberFocusLost	bmmerbmebmmmmmebmmmmebmmmebmme
this.wildcardexclude	bmmerbmmmmmmmmmmmmme
tib_ptib2	bmerbmmes
timSizeH	bmebmmes
timestarted	bmmmmmmmmme
timezoneAddr	bmmmmmmebmme
tmp.m_variant	bmersrbmmmmme
tmpIIData.endIndex	bmebmmmmerbmebmmme
tmpLevelStep	bmebmmmebmme
tmpQ.z	bmesrs
tmpchar	bmmmmme
tmpu	bmme
tnd.szTip	bmerbebme
toAbortHandlingLab	bebmmmebmmmmmmebme
todayFlexidate	bmmmebmmmmmmme
toggleConditionalBreakpoint	bmmmmebmmmmmmmmmebmmmmmmmme
toggleMinPieceSpacing	bmmmmebmebmmmebmmmmme
tok_info.hardwareVersion.minor	bmerbmmerbmmmmmmebmmmmmerbmmme
tooltipEl	bmmmmmebe
tpltObj.getName	bmmebmerbmebmme
tr_localaddr	berbmmmmmmme
track_num	bmmmerbme
transfer_RGB_FLOAT_to_YUV444P	bmmmmmmerbmerbmmmerberbmebmes
treservations	bmmmmmmmmmmme
trigname	bmmmmmme
trlRelCon	bmebmebme
trx_undo_seg_create	bmerbmmerbmerbmmmme
try_SetCought	bmerbmebmmmme
tsscContainerptr	bmmebmmmmmmmmmme
tstfillp	bmmmmmme
ttx	bme
tupleOfTVars	bmmmebebmmme
tw.sphere	berbmmmme
twosided	bmmmmmme
txMode	bebmme
txXSLTProcessor	bebmmmmmmmmmmme
txtMisc	bmebmme
u.A_WhichIO.ut_in_out_put_t_1	srsrbmmmeberberberbmerbmersrs
uClientIP	sbmmmmebe
ubody	bmmme
uf_space_prespace	berbmmmerbmmmmmme
ui64TotFileSize	bebebmebmmebmme
uiThread	bebmmmme
ui_setOrientProc	berbmebmmmmebmme
ui_teamName	berbmmebmme
ulScreenY	bebmmmmes
undirected	bmmmmmmmme
unregisterBean	bmmmmmmmmebmme
unsetFileName	bmmmebmmebmme
updatable_view	bmmmmmmmerbmme
updateAllDiffBackgrounds	bmmmmebmebmmebmmmmmmmmme
usage_getdata	bmmmerbmmmmme
use_aic	bmerbme
usemap	bmmmme
userClickText	bmmebmmmebmme
usr.isBot	bmerbebme
usrResults	bmebmmmmme
ut_stats_tag_t	berbmmmerbmers
uval.dv	bmmerbe
v4l2_parm.parm.capture.capturemode	ssssrbmmerbmmerbmmmmmerbmmmmmmmmme
va.persistent	berbmmmmmmmme
validItem	bmmmebmme
validSValuesAndGenes	bmmmebmmmmmebmebmmme
value_top_sizeof	bmmmerbmerbmmmme
var_defend	bmerbmmmme
variables.max_length_for_sort_data	bmmmmmmmerbmerbmmmmerbmerbmmerbmme
varid	bmmme
vars_need_expansion	bmmerbmmerbmmmmmmme
vdrad	bmmme
vec_transpose	bmerbmmmmmmme
versionend	bmmmmmmmme
viewx	bmmme
vlp_job	bmerbme
vmprintfes	bmmmmmmmme
vmx.ssp	bmerbme
vpage_buffer_length	bmmmerbmmmmerbmmmme
vpix.x	bmmers
vqgen	bmmme
vstr	bmme
vui.i_num_reorder_frames	bmersrbmerbmmmmmerbmmmme
wcspbrk	bmmmmme
wds	bme
wf.cbSize	berbebmme
wfDetailString	bebmmmmebmmmme
widgets.fpfToggle	bmmmmmerbmebmmmme
wins_srv_count	bmmerbmerbmmme
wndUnderMouse	bmebmmmebmmme
worker.billing_last_name	bmmmmerbmmmmmerbmmerbmme
wqueue	bmmmme
wrappedStmt.executeUpdate	bmmmmmebmmerbmmmmmebmmmme
writeCompartment	bmmmebmmmmmmmmme
writeCustomHTML	bmmmebmmmmebmme
wtype	bmmme
x264_cabac_t	sbmerbmmmers
xGetJobStaus	sbmebmebmmme
xcolor.flags	bmmmmerbmmme
xgetColumnWidth	bmmebmmmmebmmme
xpc_proto_proto	bmerbmmmerbmmme
xtVersion	bebmmmmme
xtest	bmmme
yyz_flex_debug	bmerbmmerbmmme
~AggregateTransaction	rbmmmmmmmebmmmmmmmmme
~CodeFragment	rbmmebmmmmmme
~RobotSink	rbmmmebmme
~txSyncCompileObserver	rbebmmebmmmmmebmmmmmme
