::GetPrivateProfileSection	XXbmebmmmmmebmmmmmebmmmmme
::GetScriptManagerVariable	XXbmebmmmmebmmmmmebmmmmmme
::GetTokenAt	XXbmebmmmebe
::JS_DefineUCProperty	XXbeXbmmmmebmmmmmmmme
::SetMenuItemHierarchicalID	XXbmebmmebmmebmmmmmmmmmmebe
::SetResLoad	XXbmebmebmme
::fread	XXbmmme
AAS_Error	bmeXbmmme
AAS_FreeAASLinkedEntities	bmeXbmmebmmmmmmmebmmmmmme
ACMButton	bmmmmmmme
AF_DEFAULT_TRACK	beXbmmmmmeXbmmme
AND_EXP_AST__LINE_START	bmeXbmeXbmeXXbmmeXbmmme
APPCOMMAND_BROWSER_REFRESH	bmmmmmmmmeXbmmmmmeXbmmmmme
APR_FILEPATH_ENCODING_LOCALE	bmeXbmmmmmmeXbmmmmmmeXbmmmme
APR_POLLSET_THREADSAFE	bmeXbmmmmmeXbmmmmmmmme
APR_WIN_CE_3	bmeXbmeXbeXs
APR_XML_ERROR_EXPAT	bmeXbmeXbmmmeXbmmme
ARB_shader_objects_glUniform3fARB_pointer	bmeXbmmmmeXbmmmmmeXbebmmmmmessbmeXbmmmmme
ART_UTA_BBOX_Y0	bmeXbmeXbmmeXss
ASTRewrite.TYPE	bmmmmmmmmeXbmme
ASTView	bmmmmme
AST_CDR_DOCUMENTATION	bmeXbmeXbmmmmmmmmmmme
AST_FEATURE_DISCONNECT	bmeXbmmmmmeXbmmmmmmmme
AST_LOCK_FAILURE	bmeXbmmeXbmmmmme
AST_RTP_MAX	bmeXbmeXbme
ATK_ROLE_MENU	bmeXbmmeXbmme
AUTOMATIC_DATABASE_MEMORY_URL.equals	bmmmmmmmeXbmmmmmmeXbmmmmeXbmeXbmmmme
A_RFC931	sXbmebme
ArrayToArrayInfoMap	bmmmebebmmmebmmebme
AtkCoordType	bmebmmmebmme
AtkTextIface	bmebmmebmmme
BARCODE_NO_ASCII	bmmmmmeXbeXbmmme
BIT5_H	bmesXs
BOTLIB_AI_ALLOC_CHAT_STATE	bmmmmeXbeXbmmmeXbmmeXbmmme
BSD_REGEX	bmeXbmmme
BS_PUSHBUTTON	beXbmmmmmmmme
BZipUncompress	bmmebmmmmmmmme
BaseExc	bmmebme
BlastBin2Csv	bmmmebmesbme
BlockRowPixels	bmmmebmebmmmme
BooleanECD	bmmmmmebme
BugBaseQuery.QUERY_UPDATE_BUGREPORTS	bmebmmebmmmeXbmmmeXbmmmmeXbmmmmmmmme
BulletinConstants.TAGSTATUS	bmmmmmmebmmmmmmmeXbmmmmmmme
CAInfo.SELFSIGNED	bmmmmeXbmmmmmmmme
CBM_INIT	bmeXbmme
CBuilderXProjectWriter	bmmmmmmebmmmmmmebmmmme
CCLASS_UPPER	bmmmmeXbmmme
CDSC_PSADOBE	bmmeXbmmmmme
CELLTYPE_BODY	bmmmmmmeXbmme
CERT_DecodeCertificatePoliciesExtension	bmmeXbmmmmebmmmmmmmmmebmmmmmmebmmmmmmme
CERT_SaveSMimeProfile	bmmeXbmmebmmmebmmmmme
CFArrayCreateMutable	bmmmmmebmmmmebmmmmme
CFPAnalyser	bmmmmmmmmme
CFriendListCtrl	bmmmmmebmmebmme
CGConstants.MAX_CARDINALITY_COLOR	bmmmmmmmmmeXbmeXbmmmmmmmmmeXbmmme
CHAR_DIAPRE_DECIMALE	bmmeXbmmmmeXbmmmmmme
CHECK_SERVICE_USE_OK	bmmmeXbmmmmmeXbmeXbe
CHOICEHELP	bmmmmmmmme
CHROME_DIR_NAME	bmmmmeXbmeXbmme
CHU_ERR_ERROR	bmeXbmeXbmmme
CI_SIGNATURE	beXbmmmmmmme
CKM_SHA384_HMAC	bmeXbmebmeXbmme
CK_C_INITIALIZE_ARGS	beXsXbmmmmmmmmeXbmme
CLASSTYPE_FRIEND_CLASSES	bmmmmmmmeXbmmmmeXbmmmmme
CLIENT_SSL	bmmmmeXbme
CLIENT_THREADS_MIN	bmmmmeXbmmmmmeXbme
CLabelTab	bmmmmebme
CM_BoundBrush	beXbmmmebmmme
CNumPad.FUNC_CLR	bmmebmeXbmmeXbme
CODE_null_unit_attr	bmmeXbmmeXbmmeXbmme
COLLECTION_COMPLEX_TYPE_AST__PCOLLECTION_KEY	bmmmmmmmmeXbmmmmmeXbmmeXbmeXXbmmmmmmmmmeXbme
COMPUTIME_FORMAT	bmmmmmmmeXbmmmme
CONTINUE_PREV	bmmmmmmeXbmme
CONV_OLD_CONVERT	bmmeXbmeXbmmmmme
CPU_features.i387	bmeXbmmmmmmeXsbme
CRMF_CertReqMsgSetKeyEnciphermentPOP	bmmeXbmmebmebmebmebmebmmmmmmmmmmebme
CSS_PROP_XUL	bmeXbmmeXbme
CSS_STATE_DELETED	bmeXbmmmeXbmmmmme
CSearchDlg	bmmmmmebme
CSimpleKnownFileArray	bmmmmmebmmmebmmebmmme
CStyleToken	bmmmmebmmme
CWColormap	bmmmmmmmme
CalcDiffInTotals	bmmebmmebebmmmme
CalcHorCornerOffset	bmmebmebmmmmebmmmme
Cam_MouseDown	bmeXbmmmebmme
Cbcalc	bmmmme
CdlPackage.VARIABLE__SEMANTIC_ANNOTATIONS	bmebmmmmmeXbmmmmmmeXXbmmmmmmeXbmmmmmmmmme
CharImpl	bmmebmme
ChildLocalHome.JNDI_NAME	bmmmebmmmebmmeXbmmeXbmme
ChildParentChooserWindow	bmmmebmmmmebmmmmmebmmmme
ChildrenHashOps	bmmmmmmebmmebme
ClassDescriptor.OOS_ARGS	bmmmebmmmmmmmmeXbmeXbmme
ClassType.ANNOTATION_TYPE_DECL	bmmmebmmeXbmmmmmmmmeXbmmeXbmme
CommonMainRoutine	bmmmmebmmebmmmmme
ComponentBinderImplTest	bmmmmmmmebmmmmebmmebmme
ConfigParser.QUERY_CACHE_MAX_QUERIES	bmmmmebmmmmeXbmmmeXbmmmeXbmeXbmmmmme
Console_IO.str_emph	bmmmmmeXbeXbmeXbmme
Constants.ATTR_CLASS_VALUE_SOURCE	bmmmmmmmeXbmmeXbmmmeXbmmmeXbmmmme
Constants.FSWP	bmmmmmmmeXbmme
Constants.JUNIT_DOUBLE_PRECISION	bmmmmmmmeXbmmmeXbmmmmeXbmmmmmmme
Constants.amountOf	bmmmmmmmeXbmmmmebe
ConstructAttributeTable	bmmmmmmmebmmmmmmmebmmme
CountRectProc	bmmmebmmebmme
Crawler.WEB	bmmmmmeXbme
CreateImapManageMailAccountUrl	bmmmmebmmebmmmmebmmebmmmmmebme
CreateSVGTransform	bmmmmebmmmmmmmmmme
DAlarmFields	bmmmmebmmmme
DB_VERB_CHKPOINT	beXbmmeXbmmmmmme
DCF_M	bmeXs
DC_COMMENT	beXbmmmmme
DC_OPEN	beXbmme
DECL_FIELD_SIZE	bmmeXbmmmeXbmme
DICT_POOL_PER_VARYING	bmmeXbmmeXbmeXbmmmmme
DIRECTION_NOTSET	bmmmmmmmeXbmmmme
DJP_NEXT_STRUCTP	bmeXbmmeXbmmmmme
DKGREEN	bmmmmme
DLG_ADVANCED_SETTINGS	bmeXbmmmmmmeXbmmmmmme
DLList	bmmmme
DPR_OUTPUT_URL_PARAMETER_NAME	bmeXbmmmmeXbmeXbmmmmmmmeXbmme
DRIVE_REMOVABLE	bmmmeXbmmmmmmme
DT_DEBUG	beXbmmme
DYN_ANY_FACTORY_NAME	bmeXbmeXbmmmmmeXbmme
Db_h_hash_callback	beXsXbmmeXbmmmmmme
DecimateConfig	bmmmmmmebmmmme
DefNodeWidth	bmebmmebmmme
DeleteModalityLanguageSupportAction	bmmmmebmmmmmmebmmmmmmebmmmmmebmmmme
DenoiseFFTWindow	bmmmmmebmmmmmmme
DestroyFlushEvent	bmmmmmebmmmebmmme
DestroyOidSequence	bmmmmmebmebmmmmmme
DialerCommand.CLT_UNBLOCK	bmmmmebmmmmmeXbmeXbmmmmme
DjentelParserEngineTreeConstants.JJTINDENT	bmmmmmebmmmmebmmmmebmmebmmmmmmmeXbmmmmmmme
DoHooks	bebmmme
DropDownListSpriteCO	bmmebmmebmmebmmmmebe
DublinCoreExtension	bmmmmebmmebmmmmmmme
DummyListUI	bmmmebmmebe
EAGAIN	bmmmme
ECField	bmmmmme
EC_group_fp	beXbmmmeXbe
EF_LOST	beXbmme
EL3RST	besbme
ENVVERB	bmmmmme
EOPNOTSUPP	bmmmmmmmme
ER_ILLEGAL_REFERENCE	beXbmmmmmeXbmmmmmmme
ESR_NORMAL_FONT_SIZE_DEFAULT	bmeXbmmmmeXbmmeXbmmeXbmmmmme
ESTRANGELO_SYRIAC	bmmmmmmmmeXbmmmme
EUCKR_TYPICAL_DISTRIBUTION_RATIO	bmmmeXbmmmmmeXbmmmmmmmmmmeXbmmme
EUDORAIMPORT_ADDRESS_BADSOURCEFILE	bmmmmmmmmmmeXbmmmmmeXbmmmmmmmmmmme
EncodeABC.value.const_refs	bmmmmebmeXbmmmeXbmmmeXbmme
Enum.INT_ABOVE	bmmeXbmeXbmmme
ErrTimeout	bmebmmmmme
ExportXMIReferenceProvider	bmmmmebmmmmmmmmmmebmmmmmme
FC_USERID_HINT	beXbmmmmeXbmme
FFECOM_f2ccodeCHAR	bmmmmeXssbmmmebmme
FFEEXPR_percentVAL_	bmmmmmeXbmmmmmebme
FFESTR_firstCALL	bmmmmeXbmmmebmme
FFESTR_genioSIZE	bmmmmeXbmmmebmme
FF_LOSS_COLORSPACE	beXbmmeXbmmmmmmmme
FORMATTER_BRACE_POSITION_FOR_ANNOTATION_TYPE_DECLARATION	bmmmmmmmeXbmmmeXbmmmmmmeXbmeXbmmmmmmmmeXbmmeXbmmmmmmmmme
FORM_DATAOBJECT_CONSTRUCTOR	bmmeXbmmmmmmmmeXbmmmmmmmmme
FPUL_REGS	bmmeXbmme
FSMultipartFormDataReader	bmmmmmmmmmebmmebmmebmmmme
FT_New_Stream	beXbmeXbmmmme
FT_Outline_Oblique	beXbmmmmmeXbmmmmme
FX_SPELL_PARALYZE	beXbmmmeXbmmmmmme
FileActivator	bmmebmmmmmmme
FileMgrConstants.VMODULE_ACTION_SAVE	bmmebmebmmmmmmmeXbmmmmmeXbmmmmeXbmme
FlowchartDiagramEditorPlugin.ID	bmmmmmmmebmmmmmebmmmmebmmmmeXbe
ForrestManager.COMMAND_BUILD	bmmmmmebmmmmmeXbmmmmmeXbmmme
GC_push_all_stack_partially_eager	beXbmmeXbmeXbmmmeXbmmmmmmmeXbmmme
GC_register_disappearing_link	beXbmmmmmmeXbmmmmmmmmmmeXbmme
GConfClientGetDefaultType	bmmmebmmmmebmebmmmmmebmme
GFXBYTESPERPIXEL	bmmmmmmmmmmmmmme
GGGPP_CDMA2000	bmmmeXbmmebmme
GL_COLOR	beXbmmme
GL_COLOR_BUFFER_BIT	beXbmmmeXbmmmmeXbme
GSN_FSAPPENDCONF	bmeXbmmmmmmmmmme
GSN_FSAPPENDREQ	bmeXbmmmmmmmmme
GSN_LQH_TRANSCONF	bmeXbmeXbmmmmmmme
GSN_LQH_TRANSREQ	bmeXbmeXbmmmmmme
GTK_MOZ_EMBED_FLAG_TOOLBARON	bmeXbmeXbmmmeXbmmeXbmmmmmmme
G_DATE_BAD_MONTH	sXbmmeXbmeXbmmme
GenModFigure	bmebmebmmmme
GetAtkSignalName	bmebmebmmmmebmme
GetAudioSamplesPerSec	bmebmmmebmmmmmebmebme
GetCapabilitiesKvpRequestReader	bmebmmmmmmmmmmebmebmmmmmebmmmme
GetFirstEv	bmebmmmebe
GetHighestInlineParent	bmebmmmmmebmmmmebmmmme
GetMinRowHeight	bmebmebmebmmmme
GetNormalizedPathSegList	bmebmmmmmmmmebmmebmebmme
GetOfflineOpForKey	bmebmmmmmebebmebme
GetRuntime	bmebmmmmme
GetUpData_MLDONKEY	bmebebmmeXbmmmmmme
GetWSIsEnabled	bmebmmebmmmmme
GtkStateType	bmebmmmebmme
Gvp	bme
HAVE_DECL_SYS_SIGLIST	bmmeXbmmeXbmeXbmmmmme
HAVE_trunctfdf2	bmmeXbmmmmmmmes
HF_LAMBDAFN	beXbmmmmmme
HITField.Description	bmmmmmmeXbmmmmmmmmme
HSoundsPreferencePanel	bmmmmmebmmmmmmmmebmmme
HZ_STATE_GB	beXbmmmeXbe
HandleUnregisterURLEchoEvent	bmmmmebmmmmmmmmebmmmmmebmmme
HistogramConfig	bmmmmmmmebmmmme
IAX_IE_CALLED_CONTEXT	bmeXbeXbmmmmeXbmmmmme
IActionProvider	bmmmmmebmmmmmme
ICY_METADATA_INTERVAL	bmeXbmmmmmmeXbmmmmmme
IClientDataItem	bmmmmmebmmebmme
ID3FID_YEAR	besbmeXbmme
IDC_EDIT_DATETIME	bmeXbmmeXbmmmmmme
IDC_EDIT_QUAKE2	bmeXbmmeXbmmmes
IDC_METANAME	bmeXbmmmmmme
IDC_TEXTWIN_COPY	bmeXbmmmmmeXbmme
IDC_UPDATESERVERCLIENT	bmeXbmmmmmmmmmmmmmmmme
IDI_TESTPASSED	bmeXbmmmmmmmme
IDI_UNINSTALL	bmeXbmmmmmmme
IDL_node_new	bmeXbmmeXbme
IDL_type_fixed_new	bmeXbmmeXbmmmeXbme
IDS_DL_RESUMENEXT	bmeXbeXbmmmmmmmme
IDS_HSAV	bmeXbmme
IDS_IRC_DISCONNECT	bmeXbmeXbmmmmmmmme
IDS_LASTSEEN	bmeXbmmmmmme
IEC61883_AMDTP_FORMAT_IEC958_PCM	bmebmmmeXbmmmeXbmmmmeXbmebmeXbme
IFTypeManager.IF_ATTACHMENTS	bmmmmebmmmmmeXbeXbmmmmmmmmme
IID_IHTMLElementCollection	bmeXbmmmmmmmmmmebmmmmmmmme
IMAGE_BITMAP	bmmmeXbmmmme
INIT_BLOCK_SIZE	bmmeXbmmmeXbmme
INTEL_SPINLOCKS	bmmmeXbmmmmmmme
INT_ROW_HOLIDAYS_START	bmeXbmeXbmmmmmmeXbmmme
IPC_PlatformSendMsg	bmeXbmmmmmmebmmebme
ISBADADR	bmmmmmme
ITagLibErrors	bmmebmebmmmme
IbisSerializationOutputStream.enumClass	bmmebmmmmmmmmmmmebmmmmebmmmmeXbmmebmmme
ImageMatrix.yy	bmmmebmmmmeXbe
ImageToPDF	bmmmebebme
Individual.NOT_INHERITABLE	bmmmmmmmmeXbmeXbmmmmmmmmme
InitBrowserMenu	bmmebmmmmmebmme
InitLicTxt	bmmebmebme
InitThread	bmmebmmmme
InstantiationSet	bmmmmmmmmmmmebme
IonoStationEditAction	bmmebmmmmmebmmebmmmme
Is7bitNonAsciiString	besbmebmebmmmebmmmme
Item_func_lt	bmmeXbmmeXbe
JAVA_SIGNATURE_UNKNOWN	bmmeXbmmmmmmmeXbmmmmme
JAVA_T	bmmeXs
JAWE_AUTOSAVE_PROPERTYFILE_NAME	bmmeXbmmmmmmeXbmmmmmmmmmmeXbmme
JCEProviderObject	bmmmmmmmmmebmmmme
JCasFunctionTag	bmmebmmmmmmebme
JDBCAppender.PASSWORD_OPTION	bmmmmmmmmmmeXbmmmmmmeXbmmmme
JRMeterChartFactory	bmmmmmebmmmebmmmmme
JSD_GetJSScript	bmeXbmebmmmmmme
JSPRegularExpressions.HTML_A_PATTERN	bmmmmmmmmebmmmmmmmmmeXbmmeXsXbmmmmme
JS_GetFrameAnnotation	beXbmebmmmebmmmmmmmme
JS_NEW_LOCK	beXbmeXbmme
JTRC_ADOBE	bmmeXbmmme
JXBroadcast	bmmmmmmmmme
JameleonScriptExceptionTest	bmmmmmmebmmmmebmmmmmmmebmme
Java2ObjectTypeConverter	bmmesbmmmmebmmebmmmmmmme
JavassistInstrumentorEngineTaskTest	bmmmmmmmebmmmmmmmmmmebmmmmebmmebmme
JmiChangeSet	bmebmmmmebme
KERN_PAIR_KPY	bmmeXbmmeXbme
KeyFallback	bmebmmmmmme
Keyboard.KEY_LCONTROL	bmmmmmmeXbmeXbmmmmmme
L1_WO_WAEN	ssXbeXbmme
LARGE_NUM_SOCKETS	bmmmeXbmeXbmmmmme
LBCarryMask	bmmmmmebmme
LC_LOAD_DYLIB	beXbmmeXbmmme
LDAP_CONTROL_PWEXPIRED	bmmeXbmmmmmeXbmmmmmmme
LEX_INFINITY	bmeXbmmmmmme
LIBERIA_ID	bmmmmmeXbe
LIS_SUCCESS	bmeXbmmmmme
LL_DEBUG	beXbmmme
LMTOS_LCP_CONCLUDING	bmmmeXbmeXbmmmmmmmme
LM_SELECTITEM	beXbmmmmmmmme
LOADCHOICES	bmmmmmmmmme
LOCKED_DBT	bmmmmeXbme
LOCKED_OBJ_GET_PROTO	bmmmmeXbmeXbmeXbmmme
LOGON_PRIVILEGE_NAME	bmmmeXbmmmmmmmeXbmme
LOOKUP_COMPLETE	bmmmmeXbmmmmmme
LPCM_AUDIO	bmmeXbmmme
LProgressBar	bmmmmmmmebme
LSold.Mode	bmmmeXbmme
LTRAmPTable	bmmmebmmmme
LVBKIMAGE	bmmmmmmme
LdapAttrbConst.ATTRIBUTE_MULTI_VALUED	bmmebmmmebmmmeXbmmmmmmmeXbmmmeXbmmmme
Link.INVERSEPROP	bmmeXbmmmmmmmmme
LogReaderSOAPService	bmebmmmmebmmmmmmmmme
MAC_STARTUP	bmeXbmmmmme
MALAY	bmmme
MAP_VIEW_CENTRE_LONG	bmeXbmmeXbmmmmeXbmme
MAXUSERNAMELEN	bmmmmmmmmmmmme
MAX_URI_SIZE	bmeXbmeXbmme
MD.Tempo	beXbmmme
MESSAGE_TYPE_STOP_ASSOC	bmmmmmeXbmmeXbmmeXbmmme
MF_ENABLED	beXbmmmmme
MIDIError	bmmmmmmme
MIFValueSetter	bmmmmmmebmmmme
MIN_NUMBER_OF_SIG_PER_DO_JOB	bmeXbmmmmeXbeXbmeXbmeXbeXbme
MIN_PROBABILITY	bmeXbmmmmmmmmme
MJ_FAILED_MARSHALING	beXbmmmmeXbmmmmmmmme
MK_LDAP_OBJECT_CLASS	beXbmmeXbmmmmeXbmmme
MLetTag.ArgTag	bmmebmeXbmebme
MNG_CANNOTBEEMPTY	bmeXbmmmmmmmmmmme
MNG_FN_INIT_SEEK	bmeXbeXbmmeXbmme
MNG_FN_PROCESS_DISPLAY_TRNS	bmeXbeXbmmmmmeXbmmmmmeXbmme
MNG_FN_WRITE_FRAM	bmeXbeXbmmmeXbmme
MNG_FN_WRITE_JDAT	bmeXbeXbmmmeXbmme
MOS1phiGiven	bmesbmebmmme
MOS2_CQBD	bmesXbmme
MOS2bulkJctPotential	bmesbmmebmebmmmmmmme
MOS3_VGS	bmesXbme
MOZILLA_VERSION_PROP	bmmmmmeXbmmmmmeXbmme
MP4GetTrackDuration	besbmebmmmebmmmmmme
MP4SetTrackTimeScale	besbmebmmmebmmebmmme
MP4TableProperty	besbmmmebmmmmmme
MPEG1_BUFFERINFO_LENGTH	bmmesXbmmmmmmmmeXbmmmme
MP_RESUMENEXT	beXbmmmmmmmme
MSG_DNS_LOOKUP_COMPLETE	bmeXbmeXbmmmmeXbmmmmmme
MY_KEEP_PREALLOC	beXbmmeXbmmmmmme
MY_LEX_END_LONG_COMMENT	beXbmeXbmeXbmmeXbmmmmme
MaxNoOfAttemptsC	bmebebebmmmmmmes
MedlineImporter	bmmmmmebmmmmmme
MenuBuilder.ATTACK_MENU_RELATED_DEST_1	bmmebmmmmmeXbmmmmeXbmmeXbmmmmmeXbmmeXs
MenuItemInfo.cch	bmmebmmebmmeXbme
MetaDoorExceptionHandler	bmmebmmebmmmmmmmebmmmmme
MimeMultipartSignedCMS_initialize	bmmebmmmmmmmebmmmmebmeXbmmmmmmmme
ModifiableTableChangeEvent	bmmmmmmmmebmmmebmmmmebmmme
NAMEKeyword	bmmmmmmmmme
NAME_STATE	bmmeXbmmme
NMEA_strings	bmmeXbmmmmme
NOFUN	bmmme
NSCP_MAPIDeleteMail	bmmeXbmmmmmmmmebmme
NSC_SignEncryptUpdate	bmeXbmmebmmmmmebmmmme
NSSCMSRecipientInfoID_KeyTrans	bmmmmmmmmmmmmmebmmebeXbmebmmme
NSS_CMSDigestContext_FinishSingle	bmeXbmmmmmmmebmmmmmeXbmmmmebmmmme
NS_CHARSET_DETECTOR_CONTRACTID_BASE	beXbmmmmmeXbmmmmmmeXbmmmmmmmmeXbmme
NS_DECL_NSIWMPSETTINGS	beXbmmeXbmmmmmmmmmmmme
NS_ERRORSERVICE_CONTRACTID	beXbmmmmmmmmmmeXbmmmmmmmme
NS_FRAME_IS_COMPLETE	beXbmmmeXbeXbmmmmmme
NS_FRAME_TRACE_REFLOW_OUT	beXbmmmeXbmmmeXbmmmmeXbme
NS_HKEY_CURRENT_USER	beXbmmeXbmmmmmeXbmme
NS_HTTP_STICKY_CONNECTION	beXbmmeXbmmmmeXbmmmmmmmme
NS_IROBOTSINK_IID	beXbmmmmmmmmeXbme
NS_LOADER_DATA_ALLOC_STEP	beXbmmmmeXbmmeXbmmmeXbmme
NS_MATHML_PSEUDO_UNIT_LSPACE	beXbmmmmeXbmmmmeXbmmeXbmmmme
NS_NET_STATUS_WROTE_TO	beXbmeXbmmmmeXbmmmeXbe
NS_NNTPINCOMINGSERVER_CONTRACTID	beXbmmmmmmmmmmmmmmmmeXbmmmmmmmme
NS_PRINTINGPROMPTSERVICE_CONTRACTID	beXbmmmmmmmmmmmmmmmmmmmeXbmmmmmmmme
NS_QUICKLAUNCH_RUN_KEY	beXbmmmmmmmmmeXbmeXbme
NS_REGRESSION_TESTER_CID	beXbmmmmmmmmeXbmmmmeXbme
NS_SCHEMAANYPARTICLE_CONTRACTID	beXbmmmmmmmmmmmmmmmeXbmmmmmmmme
NS_STYLE_CURSOR_DEFAULT	beXbmmmeXbmmmmeXbmmmmme
NS_STYLE_VERTICAL_ALIGN_MIDDLE	beXbmmmeXbmmmmmmeXbmmmeXbmmmme
NS_UNICODETOCP855_CID	beXbmmmmmmmmmebmeXbme
NTLMSSP_NEGOTIATE_NTLM	bmmmmmeXbmmmmmmmeXbmme
NT_STATUS_EVENTLOG_FILE_CHANGED	beXbmmmmeXbmmmmmmeXbmmeXbmmmmme
NXKeyDelete	bmmmebmmmme
N_EL_FRAME	sXbeXbmmme
NaNIndices.length	bebmmmmmmeXbmmmme
NewContainerDialog_error_enterpath	bmebmmmmmmmebmmmmeXbmmmeXbmmmmmmme
NewEventHandlerUPP	bmebmmmebmmmmmebme
NextFocusMatcher	bmmebmmmebmmmmme
OBJ_SZ_TO_BLOCKS	bmeXbeXbeXbmmmme
OFdefIOs	bmmmebme
OPT_STOP_DATETIME	bmeXbmmeXbmmmmmme
OP_TYPEUPTO	beXbmmmmmme
OS_THREAD_PRIORITY_ABOVE_NORMAL	beXbmmmmeXbmmmmmmeXbmmmeXbmmmme
OUTF_W	bmmeXs
OnFileSaveas	bebmmebmmmme
OnMsgClose	bebmebmmme
OnOptionDisabled	bebmmmmebmmmmmme
Order.LT	bmmmeXbe
PAR_INTEGERKEY	bmeXbmmmmmmmme
PCS_NOTVERIFIED	bmeXbmmmmmmmmme
PK11_ALWAYS	bebeXbmmmme
PK11_SETATTRS	bebeXbmmmmmme
PKCS11Constants.CKM_RC5_ECB	bmmebebmmmmmmmeXbmeXbesXbme
PKCS9	bmmes
PLUGINS_DIR_NAME	bmmmmmeXbmeXbmme
PLUGIN_LOG_NAME	bmmmmeXbmeXbmme
PLUS_OP__START_OFFSET	bmmeXbeXXbmmmeXbmmmme
PL_strdup	beXbmmmme
PNG_WRITE_PACK_SUPPORTED	bmeXbmmmeXbmmeXbmmmmmmme
POLYGON_EXCL	bmmmmmeXbmme
PROP_TASK_DESC	bmmeXbmmeXbmme
PRRecvfromFN	bmmmmmmmmebe
PRSeek64FN	bmmmmebebe
PR_CONTACT_DEFAULT_ADDRESS_INDEX	beXbmmmmmeXbmmmmmeXbmmmmmeXbmmme
PR_CallOnce	beXbmmebmme
PR_HOME_ADDRESS_COUNTRY_W	beXbmmeXbmmmmmeXbmmmmmeXs
PR_INSERT_LINK	beXbmmmmeXbmme
PSY_ALPHA_VERSION	bmeXbmmmeXbmmmmme
PS_COMPLETE	beXbmmmmmme
PdfAnnotPlugin.EDITOR_ID	bmebmmmebmmmmeXbmmmmeXbe
Ph_CURSOR_QUESTION_POINT	beXbmmmmeXbmmmmmmeXbmmme
Pk11Install_Platform	bebebmmmmmeXbmmmmmme
PluginVClient	bmmmmebmmmmme
PovReflectionGeneImpl	bmebmmmmmmmmebmmebmme
PrefetchHref	bmmmmmmebmme
ProcessorC	bmmmmmmmes
ProjectElement.INCLUDE_BASE_TAG	bmmmmmebmmmmmeXbmmmmmeXbmmeXbme
Project_ID3.chemin_mp3	bmmmmmeXbesXbmmmmeXbes
Pt_ARG_MOZ_AUTH_CTRL	beXbmeXbmeXbmmeXbmme
PyEval_ReleaseThread	bebmmeXbmmmmmebmmmme
QWheelEvent	bmmmmebmmme
Q_isalpha	sXbmmmmme
QoSDrxAlarmEventReceiverEventHandlerImplShell	bebmmebmmmebmmmebmmmmmmebmmmebmmmmmebmmebmmme
Qt.Key.Key_Up	beXbmeXbmeXbe
QueryField.field_type.alpha_field	bmmmebmmmeXbmmmeXbmmeXbmmmeXbmmme
RAW_CD_SECTOR_SIZE	bmeXbeXbmmmmeXbmme
RBACResourceTypeEntry	bmmmmmmmmmmebmmebmmme
READ_FIFO	bmmeXbmme
REFTREES_CHILDREFID	bmmmmmmeXbmmmmmmmme
REGISTEREDBY_AD_Reference_ID	bmmmmmmmmmmeXbeXbmmmmmmmeXbe
RELOAD_MIN_TIME	bmmmmeXbmeXbmme
REPEAT_TYPE_DAILY	bmmmmeXbmmeXbmmme
RMIApp	bmmmme
ROT_Y_LEFT	bmeXsXbmme
RaistlinServlet	bmmmmmmebmmmmme
Record.PROC_EXEC_FAILURE	bmmmmeXbmmeXbmmeXbmmmmme
RefondeDialogProprietesProjet	bmmmmmebmmmmebmmmmmmmmebmmmme
RegisterUtf8	bmmmmmmebmes
RegistryMessages.meta_registryCacheWriteProblems	bmmmmmmebmmmmmmeXbmmeXbmmmmmmebmmmebmmmebmmmmmme
Resources.EXT_PSX	bmmmmmmmeXbmeXbme
SBS_VERT	bmeXbmme
SCRAMBLED_PASSWORD_CHAR_LENGTH	bmmmmmmmeXbmmmmmmeXbmmeXbmmmme
SECKEYKeyDBHandle	bmmmmmmmebmmmmmme
SECUREOSF	bmmmmmmme
SECURE_RANDOM_ALGO_NAME	bmmmmeXbmmmmeXbmmeXbmme
SEC_SignData	bmeXbmmebmme
SET_AND_EXPR	bmeXbmeXbmme
SF_FORMAT_SD2	beXbmmmmeXbes
SHOW_SSL_CTX_SESS_ACCEPT	bmmeXbmeXbmeXbmmeXbmmmme
SHOW_SSL_CTX_SESS_HITS	bmmeXbmeXbmeXbmmeXbmme
SIMPLE_SCROLL_MODE	bmmmmeXbmmmmeXbmme
SMB_GROUP_QUOTA_TYPE	bmeXbmmmeXbmmmeXbmme
SMTP_TLS_RESPONSE	bmmeXbmeXbmmmmmme
SND_PCM_HW_PARAM_PERIODS	bmeXbmeXbeXbmmmeXbmmmmme
SND_SEQ_EVENT_INSTR_LIST	bmeXbmeXbmmmeXbmmmeXbmme
SOUNDTRACK_WEATHERAMBIENCE	bmmmmmmmmeXbmmmmmmmmmmmmme
SPL_ARCH_W32ALPHA	bmeXbmmeXsbebmmme
SPOOL_Q_REPLYOPENPRINTER	bmmmeXsXbmmmmmmmmmmmmmme
SQLCOM_SHOW_PROCESSLIST	bmmmmeXbmmeXbmmmmmmmmme
SQL_DIRECTORY_ATTR	bmeXbmmmmmmmeXbmme
SSL_ERROR_RX_MALFORMED_APPLICATION_DATA	bmeXbmmmeXbeXbmmmmmmmeXbmmmmmmmmmeXbmme
SSL_ERROR_RX_UNKNOWN_ALERT	bmeXbmmmeXbeXbmmmmmeXbmmme
SSL_set_accept_state	bmeXbmeXbmmmmeXbmmme
STATEMENTEDIT_BUF_SIZE	bmmmmmmmmmmmeXbmeXbmme
SUBLANG_ARABIC_EGYPT	bmmmmmeXbmmmmeXbmmme
SUNOS5DL	bmmmesbe
SV_AreaEntities_r	beXbmmebmmmmmmeXs
SV_ConSay_f	beXbmebmeXs
SV_RankReportStr	beXbmmebmmmmebme
SYSTEM_AGENTS_GROUP_NAME	bmmmmeXbmmmmeXbmmmeXbmme
SaveDocumentInternal	bmmebmmmmmmebmmmmmme
ServerConfig.pieceImageFile	bmmmmebmmmmeXbmmmebmmmebmme
ServerDoesntSupportACL	bmmmmebmmmmebmmmmmebme
SetLeaveAsAscii	bmebmmmebebmmme
SetMsgHdrCacheSize	bmebmebmebmmmebmme
SetUnusedInput	bmebmmmmebmmme
ShareResourceEvent.ET_ATTRIBUTE_CHANGED	bmmmebmmmmmmebmmmeXbeXbmmmmmmmeXbmmmmme
SimpleCpcClient::Parser_t::ParserStatus	bmmmmebmebmmmmessbmmmmeXsssbmmmmebmmmme
SmtpHeadersInterface.CONTENT_TRANSFER_ENCODING	bmmebmmmmmebmmmmmmmeXbmmmmmeXbmmmmmmeXbmmmmmme
SprawdzTypySkladnikow	bmmmmmebmmebmmmmmmmme
StartServer_MenuInit	bmmmebmmmmeXbmmebmme
StornoDialog	bmmmmebmmmme
StrongBinaryEncryptor	bmmmmebmmmmebmmmmmmme
StyleDisplayImpl	bmmmebmmmmmebmme
T1_Block.T1_BLOCK_R_OK	ssXbmmmeXssXbmmmeXsXbe
TAG_NL_VAR	bmeXbeXbme
TBACKGND	bmmmmmme
TBBTN_TRANSFERS	bmmmeXbmmmmmmme
TEST_NO_UUID_STRUCT	bmmeXbeXbmmeXbmmmme
TFNGui.ADD_TRANSITION	bmmmmeXbmeXbmmmmmmmme
TMADicotomicIndexedItems	bmmmmmmmmmmebmmmmmebmmme
TME_HOVER	bmeXbmmme
TOPREVFILE	bmmmmmmmme
TRACEBACK_FETCH_ERROR	bmmmmmmmeXbmmmeXbmmme
TRAinfo	bmmmmme
TRG_NUM_REQUIRED_PARAMETERS	bmeXbmeXbmmmmmmeXbmmmmmmmme
TRX_SYS_MYSQL_LOG_NAME_LEN	bmeXbmeXbmmmeXbmeXbmmeXbme
TT_PEEK_LONG	beXbmmeXbmme
TT_Round_To_Grid	beXbmmmeXbeXbmme
TX_PATTERN_DEBUG	beXbmmmmmeXbmmme
TYPE_CONFIG_TRACK	bmmeXbmmmmeXbmmme
Tags.CONST	bmmeXbmmme
TavernaIcons.importUrlIcon	bmmmmmebmmmeXbmmmmebmebmme
TeamB_correctionButton.addActionListener	bmmesXbmmmmmmmmebmmmmeXbmebmmmmebmmmmmme
Terrain_DrawXY	bmmmmmeXbmmebe
ThrowCOMError	bmmmebmmmmmme
TraitSelectorSeqHelper	bmmmebmmmmmmebmebmmmme
TypeParameter.PARAM_COMMENT	bmmebmmmmmmmeXbmmmeXbmmmmme
Types.BIGINT	bmmmeXbmmmme
UI_POPUP_INFO	beXbmmmeXbmme
UMLMetafacadeProperties.DEFAULT_IDENTIFIER_VISIBILITY	bmmmmmmmmmmmebmmmmmmmmeXbmmmmmeXbmmmmmmmmeXbmmmmmmmme
UNI_LEFT_SINGLE_QUOTE	bmeXbmmeXbmmmmeXbmmme
UPD_MM_DEL_ARRAY	bmeXbeXbmeXbmmme
UPRIGHT_RESIZE	bmmmmmeXbmmmme
USE_FREETYOE	bmeXbmmmmmme
USE_NC_EXTENSION	bmeXbeXbmmmmmmme
USE_SETREUID	bmeXbmmmmmme
UnRegisterSession	bebmmmmmmebmmmmme
UnicodeNotFromInputMethodHandler	bmmmmmebmebmmebmmmebmmmmebmmmmme
UnregisterContentPolicy	bmmmmmmmmebmmmmmebmmmme
UpdateResFile	bmmmmebmebmme
UserProperties.APP_RSRC_PREFIX	bmmebmmmmmmmmeXbmeXbmmeXbmmmme
VCARD.PRODID	bmmmeXbmmmme
VCARD_LDAP_IBMMAIL_TYPE	bmmmeXbmmeXbmmmmmeXbmme
VCCityProp	bmmmmebmme
VCFullNameProp	bmmmmebmmebmme
VLNEXT	bmmmme
VerifyRuntime	bmmmmebmmmmme
VirtualGraphics.bgcolor	bmmmmmebmmmmmmeXbmmmmme
WC_SCROLLBAR_STRING	beXbmmmmmmmeXbmmmme
WH_DEBUG	beXbmmme
WIFSIGNALED	bmmmmmmmmme
WSAEMSGSIZE	bmmmmmmmmme
WSA_GRANT_ACCESS_TO_ALL	bmeXbmmmeXbmmmmeXbeXbme
WS_CARBON	beXbmmmme
WebServiceLifecycleHandler	bmebmmmmmebmmmmmmmebmmmmme
WindowNoPanel	bmmmmebebmmme
WorkbenchPlugin.PI_WORKBENCH	bmmmmmmmebmmmmeXbeXbmmmmmmme
XC_hand2	beXbmmes
XCreateGC	bmmmmmebe
XK_KP_Delete	beXbeXbmmmme
XMLConfig.TYPEDEF_LIST_ATTR	bmmmmmmmeXbmmmmmeXbmmeXbmme
XMLCyclePrinter	bmmmmmmebmmmmme
XMLDocumentClipboard	bmmmmmmmmmebmmmmmmme
XPC_Log_Finish	bmeXbmeXbmmmme
XPT_NewXDRState	bmeXbmebmmmmmme
XVID_KEYFRAME	bmmeXbmmmmmme
XVID_ME_QUARTERPELREFINE8_RD	bmmeXbeXbmmmmmmmmmmmmmmesXbe
XpuGetResolution	bmebmebmmmmmmmme
XtMoveWidget	bebmmebmmmme
XtNminWidth	bebmmebmmme
Y4M_ERR_BADEOF	sssXbmeXbmmmme
YNormalized	bmmmmmmmmme
ZFULL_FRAGRECORD_ERROR	bmmmeXbmmmmmmmmeXbmmme
ZT_DIAL	beXbmme
_AFX_CMDTARGET_GETSTATE	XbmeXbmmmmmmmeXbmmmmmme
_BDF_DWIDTH	XbmeXbmmmme
_F_INOUT	XsXbmmme
_IO_peekc	XbeXbmmme
_Mult_Inner_Loop	XbmmeXbmmmeXbmme
_PR_HAVE_LARGE_OFF_T	XbeXbmmeXbmmmeXbmeXs
_PR_MD_MEM_UNMAP	XbeXbeXbmeXbmmme
_PR_MD_OPEN_FILE	XbeXbeXbmmeXbmme
_PT_PTHREAD_MUTEX_IS_LOCKED	XbeXbmmmmmeXbmmmeXbeXbmmmme
__db_refresh	XXbeXbmmmmme
__db_vrfy_freelist	XXbeXbmmeXbmmmmmme
__dbreg_init_print	XXbmmmeXbmmeXbmmme
__mpool_get	XXbmmmeXbme
__os_segdata_find_byname	XXbeXbmmmmmeXbmmeXbmmmme
__rw_exception	XXbeXbmmmmmmme
__txn_prepare_proc	XXbmeXbmmmmmeXbmme
_gridComponents	Xbmmebmmmmmmmme
_gsl_vector_float_view_array_with_stride_	XbmeXbmmmmeXbmmmeXbmmeXbmmmeXbmmeXbmmmme
_httpProtocolVersion	Xbmmebmmmmmmebmmmmme
_maxWallTime	Xbmebmmebmme
_pointBorderColour.setSelectedIndex	XbmmmebmmmmebmmmmeXbmebmmmmmmebmmme
_pr_solx86_clock_gettime	XbeXbmmebeXbmmmeXbmmmmme
_snd_pcm_scope_level	XbmeXbmeXbmmmeXbmmme
_strSearchTree	Xbmebmmmmebmme
a.ecart_	sXbmmme
aCallback	sbmmmmmme
aConstructorCID	sbmmmmmmmmmebme
aDesiredWidgetSize.width	sbmmmmmebmmmmebmmeXbmmme
aFrameNum	sbmmmebme
aMinVerticalPos	sbmebmmmmmmebme
aNumPagesX	sbmebmmmes
aP3PHeader	sssbmmmmme
aRGBMap	sbmmmme
aRowEndY	sbmebmes
aSVG.mStrokeOpacity	sbmeXsbmmmmebmmmmme
aTransferables	sbmmmmmmmmmmme
aUsesOCSP	sbmmebmme
aXMLTerminal	sbmmmmmmmmme
a_explanation	sXbmmmmmmmmme
aassettings.phys_watergravity	bmmmmmmmmmeXbmmeXbmmmmmmmmmme
absII	bmebe
ac3_bit_allocation.dbknee	besXbmeXbmmmmmmmmeXbmmmme
actual_type	bmmmmeXbmme
addActionSet	bmebmmmmebme
addBpelProcessUrl	bmebmmebmmmmmebme
addDocFVsToFile	bmebmebmebebmme
addLibfileset	bmebmmmmmmmme
addResumeOperation	bmebmmmmebmmmmmmme
addUsersToRol	bmebmmmebebme
addWall	bmebmme
add_decroche	bmeXbmmmmmme
addrBook	bmmebmme
addrncase	bmmmmmmme
adds	bmme
adpcm_encode_init	bmmmeXbmmmmeXbmme
ads_sid_to_name	bmeXbmeXbeXbmme
agd_serv_struct.fkt	bmeXbmmeXbmmmmeXbme
ainfo_class_initialized	bmmmeXbmmmeXbmmmmmmmmme
alloc_EXPR_LIST	bmmmeXbmmeXbmme
allows_mem	bmmmmeXbme
alsa_lisp_t	bmmeXbmmeXs
anSsrc	bebmme
ap_cpystrn	beXbmmmmme
apath.inner_box	bmmmeXbmmmeXbme
apiScanRec	bmebmmebme
appParam	bmebmmme
approxlib_ml	bmmmmmmmeXbe
apr_fcvt	bmeXbmme
argind	bmmmme
arglex_token_update_not	bmmmmeXbmmmeXbmmmmeXbme
argsbuffer	bmmmmmmmme
art_pixbuf_free_shallow	bmeXbmmmmeXbmmeXbmmmmme
asm_high_label	bmeXbmmeXbmmme
ast_dsp_get_tcount	bmeXbmeXbmeXbmmmme
ast_rtp_lookup_code	bmeXbmeXbmmmmeXbmme
ast_say_datetime	bmeXbmeXbmmmmmme
atk_state_set_add_state	bmeXbmmmeXbmeXbmeXbmmme
attConfigs	bmebmmmmme
attractorCount	bmmmmmmmebmmme
attrsExp	bmmmebme
audio_ch	bmmmeXbe
audio_strerror	bmmmeXbmmmmmme
authFinished	bmmebmmmmmme
authnokey	bmmmmmmme
autohelper_func	bmmmmmmmmeXbmme
avg_pixels8_iwmmxt	bmeXbmmmmesXbmmmme
aviSynthPanel	bmebmmmebmmme
b.m_inline	sXsXbmmmme
b.m_partsize	sXsXbmmmmmme
bAlphaIsValid	sbmmmebebmmme
backfill_outside_liberty.pos	bmmmmmmeXbmmmmmeXbmmmmmeXbme
base_init_list	bmmeXbmmeXbmme
base_source_filenames	bmmeXbmmmmeXbmmmmmmme
bb_reg_last_clobbers	beXbmeXbmmeXbmmmmmme
bcBitCount	bebmebmmme
bctu	bmme
bestbm.descent	bmmmmeXbmmmmme
bestdot	bmmmmme
beyond_eor	bmmmmeXbme
bgMeans	bebmmme
bglight	bmmmmme
bindingUri	bmmmmmebme
bisexec_environment	bmmmmmeXbmmmmmmmmme
bitmap_choice_mult_item	bmmmmeXbmmmmeXbmmeXbmme
bitsx	bmmme
bmInfo.bmHeight	bebmmeXbebmmmme
bmwidth	bmmmmme
body.cons.numSubs	bmmeXbmmeXbmebmme
bodyname	bmmmmmme
branch_gt	bmmmmeXbe
bs_write_ue	beXbmmmeXbe
bulletinUid	bmmmmmmebme
buttonEl	bmmmmebe
byCFGB	bebmme
c.ll_corner	sXbeXbmmmme
c_pointcontents	sXbmmmmmmmmmmme
cachePtr	bmmmebme
calcHeight	bmmebmmmme
calcmandfpasmstart	bmmmmmmmmmmmmmmmme
callsite	bmmmmmme
campspot_t	bmmmmmmeXs
canEditAsUserAdmin	bmebmmebebmmebmmme
catalogdownload	bmmmmmmmmmmmmme
cattrinbufFileSize	bmmmmmmmmebmmebmme
cbuf.data	bmmeXbmme
cchMatchingPath	bmebmmmmmmebmme
celtype	bmmmmme
certcount	bmmmmmmme
cf_2d_decode	beXssXbmmmme
cfirstfreelcpConnect	bmmmmmmmmmmmebmmmmme
cgm_clip_indicator	bmeXbmmeXbmmmmmmme
cgs.media.redScoredSound	bmeXbmmmeXbmebmmmmebmmme
chain_alloced	bmmmeXbmmmmme
channelmodify	bmmmmmmmmmmme
charbuff	bmmmmmme
charstring_execchar	bmmmmmmmmeXbmmmmmme
checkIfAllBound	bmmmebebmebmmme
checkStartThread	bmmmebmmmebmmmme
check_hosts_equiv	bmmmeXbmmmeXbmmme
chk2modws	bmesbmmme
chk_status	bmeXbmmmme
choice_syrecos	bmmmmeXbmmmmme
chpw_req.data	bmmeXbmeXbmme
chroma.blue.x	bmmmmeXbmmeXs
ci_collection_end	beXbmmmmmmmmeXbme
cipbp.dirInfo.ioFlAttrib	bmmmeXbmebmmeXbebebmmmme
cl.timeoutcount	beXbmmmmmmmmmme
classEntryTmpl.className	bmmmebmmmebmmeXbmmmebmme
clblPageCounter	bmmebmmebmmmmme
clcpConnectsize	bmmebmmmmmmmmme
cleanup_elt	bmmmmmeXbme
cli_add_queue_member	bmeXbmeXbmmmeXbmmmme
client_procs.copy_for	bmmmmeXbmmmeXbmmeXbme
cloneChoice	bmmmebmmmme
cm_xorot	beXbmmme
cmap_fields	bmmeXbmmmme
cmdZoomOut_mouseReleased	bmebmmebmeXbmmmebmmmmmme
cmd_PrefillForm	bmeXbmmmmmebmme
cmd_stop	bmeXbmme
cmmfCertificate	bmmebmmmmmmmmme
cmmf_CertOrEncCertSetCertificate	bmmeXbmmebebmebmmebmebmmmmmmmmme
cmodel_calculate_max	bmmmmeXbmmmmmmmeXbme
col3.green	bmesXbmmme
colorBoldCyan	bmmmebmmebmme
com.adaptiveplanning.system.SystemConfig	bmeXbmmmmmmmmmmmmmmeXbmmmmeXbmmmmebmmmme
com.agical.rmock.core.expectation.modification.MultiplicityModifier	bmeXbmmmmeXbmmmeXbmmeXbmmmmmmmmmeXbmmmmmmmmmmeXbmmmmmmmmmmebmmmmmme
com.apelon.dts.client.namespace.Namespace	bmeXbmmmmeXbmeXbmmmmeXbmmmmmmmeXbmmmmmmme
com.capgemini.mda.model.Visitor	bmeXbmmmmmmmeXbmeXbmmmeXbmmmmme
com.corendal.netapps.framework.workflow.writedatafactories.ProcessExecutionDateFactory	bmeXbmmmmmmeXbmmmmmeXbmmmmmmmeXbmmmmmmeXbmmmmmmmmmmmmmmmmeXbmmmmmebmmmmmmmebmmebmmmmme
com.esiglo.framework.core.apploader.security.jaxb.SecurityAuthorization	bmeXbmmmmeXbmmmmmmmeXbmmeXbmmmmmmmeXbmmmmmmeXbmmeXbmmmmmmebmmmmmmmmmmme
com.greendiamond.rivernorth.ui.SelectionListener	bmeXbmmmmmmmmmmeXbmmmmmmmmeXbeXbmmmmmmmebmmmmmme
com.gridsystems.module.api.ApiRegisteredType	bmeXbmmmmmmmmmeXbmmmmeXbmeXbmebmmmmmmmmebmme
com.icodeon.services.cmi.InteractionType	bmeXbmmmmmeXbmmmmmmeXbmeXbmmmmmmmmmebmme
com.kbquest.util.resource.DisposalQueueHandler	bmeXbmmmmmeXbmmeXbmmmmmmeXbmmmmmmebmmmebmmmmme
com.kopiright.bytecode.classfile.Member	bmeXbmmmmmmmeXbmmmmmmeXbmmmmmmmeXbmmmme
com.projity.pm.scheduling.SchedulingRule	bmeXbmmmmmeXbeXbmmmmmmmmeXbmmmmmmmmebmme
com.projity.pm.snapshot.SnapshottableImpl	bmeXbmmmmmeXbeXbmmmmmmeXbmmmmmmmmmmmebmme
com.sun.rave.web.ui.component.Label	bmeXbmeXbmmeXbmeXbeXbmmmmmmmeXbmmme
com.sun.rave.web.ui.component.TableRowGroup	bmeXbmeXbmmeXbmeXbeXbmmmmmmmeXbmmmebmebmmme
com.sun.star.i18n.KParseTokens	bmeXbmeXbmmeXsbesXbmmmmebmmmme
com.sun.tools.internal.ws.util	bmeXbmeXbmmmeXbmmmmmmeXbeXbmme
com.sun.tools.javac.main.JavacOption.HiddenOption	bmeXbmeXbmmmeXbmmmeXbmmeXbmmmebmmmmeXbmmmmebmmmme
com.wm.povclipse.property.megapovxrs.ServerTab	bmeXbeXbmmmmmmmeXbmmmmmmeXbmmmmmmmmeXbmmmmebme
com.xerox.VTM.engine.LongPoint	bmeXbmmmeXbmeXbmmmmeXbmmebmmme
commentBooleans	bmmmmmebmmmmmme
compNameBytes.length	bmmebmmebmmmeXbmmmme
completeDropTrigger	bmmmmmmebmmebmmmmme
compress_init	bmmmmmmeXbmme
computeBreakpointAdornmentFlags	bmmmmmebmmmmmmmmebmmmmmmmebmmme
computedMinHeight	bmmmmmmebmebmmmme
conf.lists.indexed	bmmeXbmmmeXbmmmmme
config.yellow	bmmmmeXbmmmme
configuration.overview	bmmmmmmmmmmmeXbmmmmmme
conn_options.secmode	bmmeXbmmmmmeXbmmmmme
connectpath	bmmmmmmmmme
consumeUnmappedDatastoreField	bmmmmmebmmmmmmebmmmmmmmebmmme
containerinfo	bmmmmmmmmmmme
contextSupport.createManagedCollection	bmmmmmebmmmmmeXbmmmmebmmmmmebmmmmmmmme
contractidString	bmmmmmmmmebmmmme
convertOB	bmmmmmebe
corrigeAngles	bmmmmmebmmmme
cos_lat_M_cos_lon	bmeXbmeXsXbmeXbme
createChargeLabel	bmmmmebmmmmebmmme
createFDC	bmmmmebme
createHistoryFeedPlugin	bmmmmebmmmmmebmmebmmmme
createJMSAdapter	bmmmmebmmmmmmmme
createResourceHandler	bmmmmebmmmmmmebmmmmme
createVerCurso16	bmmmmebmebmmmebe
crlfHeaders	bmmebmmmmme
crmf_create_prtime	bmmeXbmmmmeXbmmmme
cryptoMech	bmmmmebmme
crypto_flags	bmmmmeXbmmme
csSEI.fMask	bebmeXsbmme
cs_file_sec	beXbmmeXbme
ctimebar_h	bmmmmmmeXs
ctop	bmme
curHdr	bmebme
cur_client.reg.isreg	bmeXbmmmmeXbmeXbmmme
currentAppPosition.y	bmmmmmebmebmmmmmmeXs
currentCtx	bmmmmmebme
customLayoutParameter.pageNumber	bmmmmebmmmmebmmmmmmmeXbmmebmmmme
dDelayed	sbmmmmme
dInf.widthMember	sbmeXbmmmebmmmme
d_rcode	sXbmmme
databufptr	bmmmmmmmme
dayLengthLabel	bmebmmmmebmmme
dbArray	bebmmme
dbObj.ward_id	bebmeXbmmeXbe
dbc_ctp	bmeXbme
dbt	bme
dc1394_start_iso_transmission	bebmmeXbmmmeXbmeXbmmmmmmmmmme
dcA_Partner	besXbmmmmme
de.anomic.tools.dirlistComparator	beXbmmmmeXbmmmeXbmmmmmebmmmmmmmme
deGappedConsensus	bebmmmmebmmmmmmme
deadsec	bmmmmme
dec.signature_	bmeXbmmmmmmme
declLambda	bmmebmmmme
delWalk	bmebmme
del_l	bmeXs
del_visible_faces	bmeXbmmmmmeXbmmme
deleteUbication	bmmmmebmmmmmmme
dev_proc_fill_mask	bmeXbmmeXbmmeXbmme
device_prefs	bmmmmeXbmmme
dfield_copy_data	bmmmmeXbmmeXbmme
di.pDatatype	beXsbmmmmmme
dialogMsg	bmmmmebme
dialog_cb	bmmmmeXbe
dictname	bmmmmmme
dirPropCount	bmebmmebmmme
dirYoffset	bmebmmmmme
dirst	bmmme
displayOptionsInfo.brightness.maxvalue	bmmmmmebmmmmmebmmeXbmmmmmmmmeXbmmmmmme
div_r	bmeXs
dladdr	bmmmme
dll_eth_get_work	bmeXbmeXbmeXbmme
doCarteCharacters	bebmmmebmmmmmmmme
do_jump_for_compare	beXbmmeXbmeXbmmmmme
do_layer3_sideinfo	beXbmmmesXbmmmmmme
do_list_fn	beXbmmeXbe
do_unlink	beXbmmmme
dollar_in_ident	bmmmmeXbeXbmmme
domain_obj	bmmmmeXbme
domss	bmmme
dop.pdriv	bmeXbmmme
dosrcs	bmmmme
double_min	bmmmmeXbme
dp_conf_t	beXbmmeXs
dpre	bmme
dragAddNode.drawy	bmmebmebmmeXbmmme
dragitem.fsSupportedOps	bmmmmmmeXbebmmmmmmmebme
drawMst	bmmebme
drawTimeBox	bmmebmmebme
drift_comp	bmmmeXbmme
dsc_orientation	bmeXbmmmmmmmmme
dst0.x	bmesXs
dst_buffer_to_hmac_md5	bmeXbmmmmeXbeXbmmeXbes
dtstart.year	bmmmmmeXbmme
dtype_form_prtype	bmmmeXbmmeXbmmmme
durations	bmmmmmmme
dv_init_dct248	beXbmmeXbmebme
dv_video_source	beXbmmmeXbmmmme
dwUpperLimit	bebmmmebmmme
dwUser	bebmme
dw_mode	beXbmme
dwarf2out_return_reg	bmmmesbmeXbmmmmeXbme
dwl	bme
eCSSKeyword_scrollbartrack_vertical	sbmmmmmmmmeXbmmmmmmmmmmmmeXbmmmmmme
eOnDataAvail	sbebmmebmmme
eSendBehindFront	sbmmebmmmmebmmme
eStyleStruct_Max	sbmmmebmmmmeXbme
eSystemFont_Tooltips	sbmmmmebmmeXbmmmmmme
e__SystemEnumStrict_n_from_then_to_uts	sXXbmmmmebmmebmmmmeXsXbmmeXbmmeXbeXbme
ectr	bmme
edu.colorado.phet.energyskatepark.view.piccolo.SkaterNode	bmeXbmmmmmmeXbmmeXbmmmmmmmmmmmmmeXbmmeXbmmmmmeXbmmmmebmme
eh_proto	beXbmmme
emb_read_rows	bmeXbmmeXbmme
encodeDiv	bmmmmebme
encodeXMLWideFieldElement	bmmmmebmmmmmebmmmebmmmmme
endtravelflags	bmmmmmmmmmmmme
entry_ptr	bmmmeXbme
env.width	bmeXbmmme
eod	bme
eq_func	beXbmme
equivs_.last	bmmmmeXXbmme
errFileOpen	bmebmmebmme
error2ECD	bmmmesbme
errorWarning.filename	bmmmebmmmmmeXbmmmmmme
error_mark_node	bmmmeXbmmeXbmme
evTimeRW	bebmmebe
ex_coeff_d	beXbmmmeXs
exact_sos_count	bmmmeXbmeXbmmme
examples.jaxb	bmmmmmmeXbmme
execCM_ADD	bmmebeXbme
execDICTSTARTCONF	bmmebmmmmmmmmmmme
execDI_FCOUNTCONF	bmmebeXbmmmmmmmme
execTUP_ALLOCREQ	bmmebmeXbmmmmmme
execWAIT_DROP_TAB_REQ	bmmebmmeXbmmeXbmeXbme
execute_ln	bmmmmmeXbe
existingNode	bmmmmmmebmme
explodedDisplay	bmmmmmmebmmmmme
expn	bmme
exportPHYLIPINTERFile	bmmmmebmmmmmmmmmmmmme
extractClientEntriesFromUrl	bmmmmmebmmmmebmmmmmebmmebme
f__curunit	sXXbmmmmme
f_bkpt	sXbmme
fartherin	bmmmmmmme
fastmin	bmmmmme
faviconGeneratorElement	bmmmmmebmmmmmmmebmmmmme
fbuffer	bmmmmme
fc.privateContext	beXbmmmmmebmmmmme
fcheckData.data	bmmmmebmmeXbmme
fdlMeta.left	bmebmmeXbmme
fdset	bmmme
ff_mpeg1_find_frame_end	beXbmmesXbmmeXbmmmeXbme
ffebld_constant_realdefault	bmmmmeXbmmmmmmeXbmmmmmmmmme
ffeexprOperator_	bmmmmmebmmmmmme
ffestp_file.type	bmmmmeXbmmeXbmme
ffetarget_offset_add	bmmmmmmmeXbmmmmeXbme
fftw_sem_post	bmmeXbmeXbmme
field_idx	bmmmeXbme
filesort_limit	bmmmmmmeXbmmme
fill_params	bmmeXbmmmme
findHostHealths	bmmebmmebmmmmme
findSplitRTleaf	bmmebmmmebmmmme
first_resize_height	bmmmeXbmmmmeXbmmmme
flFlags	bebmmme
flag_schedule_insns	bmmeXbmmmmmmeXbmmme
fname.chars	bmmmeXbmmme
fontAFM	bmmebme
fontColorLU	bmmebmmmebe
forceUnixStyle	bmmmebmmebmmme
format.mSystemId	bmmmmeXsbmmmmebe
foundDirID	bmmmebmebe
fpMediaInfo4_Info_Version	bebmmmebmmesXbmmeXbmmmmme
fp_delete	beXbmmmme
fpmp	bmme
fr.tm.elibel.smartqvt.qvt.imperativeocl.ImperativeExpression	beXbeXbmmmmeXbmmmmmmeXbmeXbmmmmmmmmmmmeXbmmmmmmmmebmmmmmmmme
frame_num_offset	bmmmeXbmeXbmmmme
free_debug_proc	bmmeXbmmmeXbmme
fsControl	bebmmmmme
ft_cleanup_stack_done	beXbmmmmmeXbmmmeXbmme
ftpAdapter	bmebmmmmme
fuUsage	bebmmme
fullurlC	bmmmmmes
func_items	bmmeXbmmme
g640x480x16_regs	sbmesbmesbeXbmme
gCatInfoPB.hFileInfo.ioFlXFndrInfo	sbmebmmebeXsbmmebmmeXbebebmmmebmme
gConstNoneCharSetMap	sbmmmebmmebmmebmebme
gOverlay.the_gui	sbmmmmmeXbmeXbme
gRootAtkObject	sbmmebmebmmmme
gU2Ntable	sssbmmmme
g_EUCTWShiftTableSet	sXbmmmmmmmmebmmmebme
g_MacTurkishMappingTable	sXbmebmmmmmebmmmmmebmmme
g_date_update_dmy	sXbmmeXbmmmmeXbme
g_nVecVariableCount	sXsbmebmmmmmmebmmme
g_node_new	sXbmmeXbme
g_return_if_fail	sXbmmmmeXbeXbmme
g_ufCP949NoKSCHangulMapping	sXbebebmebebmmmmmmmebmmmmme
gcLocksHash	bebmmmebmme
gdk_draw_image	bmeXbmmeXbmmme
gdk_pixmap_create_from_xpm	bmeXbmmmmeXbmmmmeXbmmeXbme
gdk_x11_atom_to_xatom	bmeXsbeXbmmeXbeXbmmme
ge.col_fuzzy	beXbmeXbmmme
gen_nonce_hash	bmeXbmmmeXbmme
gencache_iterate	bmmmmmmeXbmmmmme
generateFrameFile	bmmmmmmebmmmebmme
generateShadowsToXML	bmmmmmmebmmmmmebebme
getAllByName	bmebmebebmme
getAssociatedJoinDeclares	bmebmmmmmmmmebmmebmmmmmme
getBusinessPClassDC	bmebmmmmmmebmmmmebe
getConfigurationDao	bmebmmmmmmmmmmmebme
getConfigurationDir	bmebmmmmmmmmmmmebme
getCopyCheckbox	bmebmmebmmmmmme
getDoubleObjectArray	bmebmmmmebmmmmebmmme
getEOLMarkers	bmebmmmmmmmme
getEn_db_id	bmebeXbeXbe
getGLJournalID	bmebmmmmmmmebe
getIdxElt	bmebmebme
getImageFromPlugin	bmebmmmebmmebmmmme
getInvKindName	bmebmebmmebmme
getKindOfStockTransactionDC	bmebmmebebmmmebmmmmmmmmmebe
getLastAdmInDateGregorian	bmebmmebmebebmmebmmmmmmme
getLastNumReturnValues	bmebmmebmebmmmmebmmmme
getLastViewedSys	bmebmmebmmmmebme
getMBMessageService	bmebmmmmmmmebmmmmme
getMaxIn	bmebmebe
getNSMapping	bmebmmmmmmme
getNumeroFils	bmebmmmmebmme
getObsXCoord	bmebmebmmmme
getOfBOM	bmebebme
getPHPProjects	bmebmmmmmmmmme
getPrefString	bmebmmebmmmme
getStdInName	bmebmebebmme
getTblOverlap	bmebmebmmmmme
getTimersAsXml	bmebmmmmebebme
getUIRenderer	bmebmmmmmmmme
getVersionservidor	bmebmmmmmmmmmmmmme
getViolatedConstraints	bmebmmmmmmebmmmmmmmmme
get_address_gsl_matrix_long_double_max_index	bmeXbmmmmmeXbmeXbmmmmeXbmmeXbmmmmeXbmeXbmmme
get_callerid_ast	bmeXbmmmmmmeXbme
get_toc	bmeXbme
get_tsd	bmeXbme
getcolor	bmmmmmme
getservbyname	bmmmmmmmmmmme
getterAtom	bmmmmebmme
gmlltmp	bmmmmme
gov.usda.gdpc.GenotypeExperimentProperty	bmeXbmmeXbmmeXbmmmmmmebmmmmmmmmebmmmmmme
gram_vsa	bmmeXbme
greenRGB	bmmmebme
grid.xaxis.circular.hmt	bmmeXbmmmeXbmmmmmmeXbme
gridBagConstraintsX.gridx	bmmebmebmmmmmmmmmesXbmmme
gs_malloc	beXbmmmme
gtk_widget_ensure_style	bmeXbmmmmeXbmmmmeXbmmme
gx_remap_concrete_gray	beXbmmmeXbmmmmmmeXbmme
gz_compress_mmap	beXbmmmmmmeXbmme
h263_chroma_roundtab	sbmeXbmmmmeXbmmmmmme
handle_channelstatus	bmmmmeXbmmmmmmmmmmme
hbit	bmme
headExp	bmmebme
help_dimu	bmmeXbmme
hiddenXMax	bmmmmebmme
highestX	bmmmmmes
hisip	bmmme
hit.linkcount	bmeXbmmmmmmme
hlib	bmme
hookGraphicalViewer	bmmebmmmmmmmebmmmme
horzVis	bmmebme
hpb.ioDirID	bmeXbebmebe
hpcxs	bmmme
htdbm_init	bmmmeXbmme
html40Latin1	bmmebebmmmes
hval	bmme
hwndCancel	bmmebmmmme
i.lvals	sXbmmme
iCCP_TYPE	sbmeXbmme
iMin	sbme
iTermcond	sbmmmmmme
i_qp0_cost2_table	sXbesXbmmesXbmmme
icause	bmmmme
icmLuMonoFwd_map	bmebebmmebmeXbme
icmTextDescription_get_size	bmebmmebmmmmmmmmmeXbmeXbmme
iconLense	bmmebmmme
iconv_close	bmmmeXbmmme
id_clash_len	beXbmmmeXbme
idct_cosine_table	bmmeXbmmmmeXbmmme
idmlinitiative.resources.dtds.aida22.impl.IDTypeImpl.Unmarshaller	bmmmmmmmmmmmmeXbmmmmmmmeXbmmeXbmmebeXbmmeXbmmmmebmmeXbmmmmmmmmmme
iff	bme
ijintArrayame	bmmmebmmmmmme
illegalNums	bmmmmmebmme
imgHeight	bmebmmmme
inFERange	bebmmmmme
inPathLen	bebmmebme
in_conns.remove	beXbmmmeXbmmmme
includedTocFile	bmmmmmmebmebmme
includes_AST_in	bmmmmmmeXbmeXbe
indFullresPath	bmebmmmmmebmme
indexOpId	bmmmebebe
index_rtx	bmmmeXbme
info.magnolia.cms.beans.runtime.Document	bmmeXbmmmmmmeXbmeXbmmmeXbmmmmmeXbmmmmmme
initDBWishlists	bmmebmmmmmmmmme
initImageBuffer	bmmebmmmebmmmme
init_g16_i	bmmeXsbeXs
init_outer_loop	bmmeXbmmmeXbmme
init_q_auth_2	bmmeXsXbmmeXs
init_reg_q_close	bmmeXbmeXsXbmmme
initarea	bmmmmmme
initialClearApars	bmmmmmebmmmebmmme
initialConnectionSql	bmmmmmebmmmmmmmmebme
interdata	bmmmmmmme
intra_only	bmmmeXbmme
ioBuffer	bebmmmme
ipcServiceConstructor	bmebmmmmmebmmmmmmmmme
ipchat.info.infoFrame	bmmmmeXbmmeXbmmebmmme
iquant_intra_m2	bmmmmeXbmmmeXss
irpd_getservbyname	bmmeXbmmmmmmmmmmme
isIgnoreLoginState	bebmmmmebmmmebmmme
isMaxnumingroupModified	bebmmmmmmmmmmmebmmmmmme
isapi_lookup	bmmmeXbmmmme
isaplot	bmmmmme
isldvowel	bmmmmmmme
issuerSHA1KeyHash.len	bmmmmebmesbmebmmeXbme
iswrite	bmmmmme
it.tidalwave.bluemarine.text.APEXApertureFormat	beXbmmmmmmmeXbmmmmmmmmeXbmmeXbmmmmmmmmmmebmmmme
itemLast	bmmebmme
itemnr	bmmmme
jace.proxygen	bmmeXbmmmmmme
jadEncoding	bmebmmmmmme
java_class_or_instance	bmmeXbmmmeXbeXbmmmmmme
javax.management.remote.rmi	bmmmeXbmmmmmmmmeXbmmmmeXbme
jdoBeforeUpdate	bmebmmmmebmmmme
jmi_wreset	bmeXbmmmme
jpegTags	bmmebmme
jpeg_consume_input	bmmeXbmmmmmeXbmmme
jrenderer	bmmmmmmme
jsTypeTags_	bebmmebmme
js_Invoke	beXbmmmme
jsd_IsValuePrimitive	bmeXbebmmmebmmmmmmme
jserv_pool	bmmmeXbmme
jsoSourceFolder	bmebmmmmebmmmme
jsystray	bmmmmmme
jwo	bme
kBoPoMoFoOrderIdCID	sbebebebebmmmebebme
kCurrentCWPanelListVersion	sbmmmmmebmmmmmebmmebmmmmme
kDOMImplementationCID	sbmmmmmmmmmmmmmmmebme
kFirstDirSize	sbmmmebmebmme
kIDataFlavor	sbmmmebmmmme
kInitSavePageDelay	sbmmebmmebmmebmmme
kInputStreamChannelCID	sbmmmebmmmmebmmmmmebme
kMsgAccountManagerCID	sbmebmmmmmebmmmmmebme
kNC_Description	sbeXbmmmmmmmmme
kSqrChar	sbmebmme
kTelugu	sbmmmme
kaboom	bmmmme
keaParams.originatorKEAKey.len	bmebmmmmeXbmmmmmmmmebmmmmeXbme
key_derive	bmeXbmmmme
keysToDelete	bmmebebmmmme
keytext	bmmmmme
kmap	bmme
lad_fs.total	bmeXbeXbmmme
langKannada	bmmebmmmmme
langTagalog	bmmebmmmmme
lang_list	bmmeXbmme
lastStartPosMatch	bmmebmmmebmebmmme
lastTimeTick	bmmebmmebmme
lblCounter	bmebmmmmme
lcpFragmentId	bmebmmmmmmebe
lcpPtr.i	bmebmeXs
ldap_err2string	bmmeXbmesbmmmme
leitchdev	bmmmmmmme
lft_rb	bmeXbe
libjava	bmmmmme
linktooltip	bmmmmmmmmme
lis	bme
lister_print_horizontal	bmmmmeXbmmmeXbmmmmmmmme
localQDefaultTriggerMsgPriority	bmmmebmmmmmmebmmmmmebmebmmmmmme
local_freed_mem	bmmmeXbmmmeXbme
logBlendFunc	bmebmmmebmme
loginTabPane	bmmmebmebmme
logval_status	bmmmmeXbmmmme
loopinfo	bmmmmmme
lowbits	bmmmmme
lpc10.dec	bmebeXbme
lsa_io_r_lookup_names	bmeXbeXsXbmmmmeXbmmme
lsa_io_r_query_info2	bmeXbeXsXbmmmeXbmmes
lum_green_weight	bmeXbmmmeXbmmmme
lunch_defendj	bmmmeXbmmmmme
mBackgroundYPosition	sbmmmmmmmmebmmmmmmme
mComputedMinWidth	sbmmmmmmebmebmmme
mDefaultNamespaceID	sbmmmmmebmmmmmmmebe
mDeque.mSize	sbmmmeXsbmme
mHTMLBindingStr	sbmmmmmmmmmebme
mLenBuf	sbmebme
mMozAreaClosestParent	sbmebmmebmmmmmebmmmme
mMozWindowWidget	sbmebmmmmebmmmme
mNKeys	sbmmme
mNumItems	sbmebmmme
mPACURL	sbmmmme
mPath.mLen	sbmmeXsbme
mPropertyCount	sbmmmmmmebmmme
mReqUploadStreamLength	sbmebmmmmebmmmmebmmmme
mSpec.vRefNum	sbmmeXsbmebme
mStartCData	sbmmmebmmme
mSubType	sbmebmme
mTargetSpec.vRefNum	sbmmmmebmmeXsbmebme
mWyciwygChannel	sbmmmmmebmmmmme
m_MarginHeaderFooterTab.m_HeaderRightText	sXbmmmmebmmmmebmmmmebmeXsXbmmmmebmmmebmme
m_ToolTip.m_hWnd	sXbmmebmeXsXsbme
m_bGPLEvildoer	sXsbmmmmmmmmme
m_bircsoundevents	sXbmmmmmmmmmmmmme
m_charCommonMax	sXbmmebmmmmebme
m_crSelectedTextColor	sXbebmmmmmmebmmebmmme
m_csBtn1Text	sXbebmesbmme
m_ctrlUpdateServerFrm	sXbmmebmmmmebmmmmebme
m_firstExecutedScanOp	sXbmmmebmmmmmmebmmebe
m_iMaxChatHistory	sXsbmebmmebmmmmme
m_iSentMoreReq	sXsbmmebmmebme
m_mozstatus	sXbmmmmmmme
m_namespaceSupport	sXbmmmmmmmebmmmmme
m_nsCard	sXbebmme
m_originalPhysicalUri	sXbmmmmmmebmmmmmmebme
m_pfn_qglCallLists	sXbmeXbmebmmebmmme
m_pfn_qglTexCoord2f	sXbmeXbmebmebmmmess
m_pk2len	sXbesbme
m_preSetItem	sXbmebmebmme
m_sLDAPSearchBase	sXsbmmmmmmmmebmme
m_sizeHdrImgListIcon.cy	sXbmmebmebmebmmebmmeXbe
m_strHost	sXbmebmme
m_wndEvents	sXbmebmmmme
mac_error	bmeXbmmme
makeConnectString	bmmebmmmmmebmmmme
makeSvgFile	bmmebmebmme
make_const_array	bmmeXbmmmeXbmmme
mapFriend	bmebmmmme
mappedUiString.autoSurround	bmmmmebebmmmmeXbmmebmmmmmme
marshalledRegs	bmmmmmmmmebmme
mask.ccolor.pattern	bmmeXbmmmmeXbmmmmme
max.setLongValue	bmeXbmebmmebmmme
maxLeafToRootPath	bmebmmebebmmebmme
max_label	bmeXbmmme
max_portals	bmeXbmmmmme
maxdy	bmmme
maybe_cc0_setter	bmmmeXbesXbmmmme
maybepermanent_obstack	bmmmmmmmmmmmmeXbmmmmme
md.waiter_sem	beXbmmmmeXbme
mdef.operation	bmmeXbmmmmmmme
mdia.minf.stbl.stsz.sample_size	bmmeXbmmeXbmmeXbmmeXbmmmmeXbmme
mec.dwSampleRate	bmeXbebmmmmebmme
mechanism.ulParameterLen	bmmmmmmmeXbebmmmmmmmebme
memPercent	bmebmmmmme
menu_open_new_cb	bmmeXbmmeXbmeXbe
menuitem	bmmmmmme
messageCtchar.getValueLength	bmmmmmebmmmmeXbmebmmmebmmmme
metaKeyArg	bmmebmebme
mgcp_reload	bmmeXbmmmme
mgr_next_row	bmeXbmmeXbme
minResidualCapacity	bmebmmmmmmebmmmmmme
minplayers	bmmmmmmmme
mixmonitor_flags	bmmmmmmmmeXbmmme
mng_ani_trnsp	bmeXbmeXbmmme
mng_display_rgb8_a8	bmeXbmmmmmeXbmesXss
mng_magnify_y	bmeXbmmmmmeXs
mng_processsave	bmeXbmmmmmmmmme
mng_store_jpeg_ga8	bmeXbmmmeXbmmeXbes
mod.mod_op	bmeXbmeXbe
moduleDir	bmmmmebme
morkCh_kN	bmmebeXss
morkMagic_kThumb	bmmebmmmeXsbmmme
morseCoder	bmmmebmmme
mp4ff_get_track_type	besbeXbmeXbmmmeXbmme
mpeg3_aa_cs	bmmesXbeXbe
mpeg3demux_movie_size	bmmesbmmmeXbmmmeXbmme
mpeg_quant	bmmeXbmmme
mpegts_demux	bmmmmeXbmmme
mprLogPagePtr	bmebmebmmebme
mq_mess.PROC_NR	beXbmmeXbmmeXbe
msgChunk	bmebmmme
msgIsInLocalCache	bmebebebmmmebmmme
msgwin	bmmmme
mtcm	bmme
mutation.mAttrName	bmmmmmmeXsbmmebmme
myDialog.m_flagvalue	bebmmmmeXsXbmmmmmmme
myPDayAL	bebmmebe
mysql_kill	bmmmeXbmme
naarani.Design.Table	bmmmmmeXbmmmmeXbmmme
nativeFolderName	bmmmmebmmmmebmme
naturalLogBase	bmmmmmebmebmme
nbrTableCols	bmebmmmebmme
ndbcluster_find_files	bmmmmmmmmeXbmmeXbmmme
negative_ok	bmmmmmmeXbe
net.matuschek.util.ByteBuffer	bmeXbmmmmmmmeXbmmeXbmmebmmmme
net.sf.fixtag.app	bmeXbeXbmmmmeXbme
net.sourceforge.barbecue.env.HeadlessEnvironment	bmeXbmmmmmmmmmeXbmmmmmmeXbmeXbmmmmmmebmmmmmmmmme
net.sourceforge.island.authentication.AuthenticationException	bmeXbmmmmmmmmmeXbmmmmeXbmmmmmmmmmmmmeXbmmmmmmmmmmmmebmmmmmmme
net.sourceforge.jt673.joules	bmeXbmmmmmmmmmeXbebmeXbmmmme
net.sourceforge.ojb2hbm.OJB2Hbm	bmeXbmmmmmmmmmeXbmesbmeXbmesbme
networkOptionsInfo.display.string	bmmmmmebmmmmmebmmeXbmmmmmeXbmmmme
newChemBond	bmebmmebmme
newCirc	bmebmme
newExtnValue	bmebmmebmmme
newInsertPosRect	bmebmmmmebmebmme
newStreamFilterAction	bmebmmmmebmmmmebmmmme
newlnf	bmmmme
nextProcessPsn.lowLongOfPSN	bmmebmmmmmebmeXbmebmmebebme
nextfield	bmmmmmmme
nextfreeoverrec	bmmmmmmmmmmmmme
nfCompRep	bebmmebme
nmemb	bmmme
nodestateUnits.addElement	bmmmmmmmebmmmeXbmebmmmmme
nodevalues	bmmmmmmmme
notQButton	bmebmmmmme
npos	bmme
nr_AppendDesc	beXbmmmmebmme
nsAString::char_type	bebmmmmmessbmmeXbmme
nsCSSValueListSH	bebmmmmmmebmmebe
nsCaseConversionImp2	bebmmebmmmmmmmmebmes
nsCopyFileMessageType	bebmmebmmebmmmmmebmme
nsDOMEventGroup	bebmmmmmmebmmme
nsDeviceContextSpecFactoryMac	bebmmmmebmmmmmebmmebmmmmmebme
nsDocumentType	bebmmmmmmebmme
nsDrawingSurfacePh	bebmmmmmebmmmmmebe
nsFontGTKUserDefined	bebmmebmmmmmebmmmmme
nsHTMLOListElement	bebmmmmmmmebmmmmme
nsIAbView	bebmebmme
nsIAboutModule	bebmmmmebmmmme
nsILocaleFactory	bebmmmmmebmmmmme
nsINativeComponentLoader	bebmmmmmebmmmmmmmebmmmme
nsIXPTLoader	bebmmmmmmmme
nsImapOfflineToOnlineCopy	bebmmebmmmmmebebmmmmebmme
nsKeyPairInfoStr	bebmebmmebmmebme
nsLDAPSSLConnect	bebmmmmmmmmmmmme
nsMathMLmoverFrame	bebmmebmmmmmebmmme
nsMdbTableEnumerator	bebmebmmmebmmmmmmmme
nsMouseMove	bebmmmebmme
nsMsgAccountManagerDataSource	bebmebmmmmmebmmmmmebmmebmmmme
nsPasteNoFormattingCommand	bebmmmebebmmmmmmmmebmmmmme
nsSOCKSIOLayerAcceptRead	bebmmmmmmmmmmebmmmmebmme
nsSelectionCommandsBase	bebmmmmmmmebmmmmmmebmme
nsSharableString::shared_buffer_handle_type	bebmmmmmmebmmmmessbmmmmeXbmmmmeXbmmmmeXbmme
nsSingleSignOnProfileObserver	bebmmmmebmmebebmmmmmebmmmmmme
nsUnicharStreamLoader	bebmmmmmebmmmmebmmmme
nsUnicodeToBIG5HKSCSConstructor	bebmmmmmebebmesbmmmmmmmmmmmmmme
nsUnicodeToBIG5NoAscii	bebmmmmmebebmesbebmmme
nsVoidBTree::Path	bebmmebmmmessbmme
nsXULTabAccessible	bebmmmmebmmmmmmmme
nsldapi_close_connection	bmmmmmeXbmmmeXbmmmmmmmme
nsocks	bmmmme
nss	bme
nssCryptoContext_FindCertificatesBySubject	bmebmmmmebmmmmmeXbmmebmmmmmmmmmmebebmmmmme
nssPKIXAttribute_SetType	bmebmmmmmmmmmmmeXbmebmme
ntriangoli	bmmmmmmmme
ntv	bme
numOfRootChoreos	bmebebmmebmmmmme
numTargetTables	bmebmmmmebmmmme
num_deaths	bmeXbmmmme
num_fixed_sizes	bmeXbmmmeXbmmme
num_syncword	bmeXbmmmmmme
o.f_stringarray	sXsXbmmmmmmmmme
oDontFeedMe	sbmmebmmebe
oWPUB	sbmme
objectcontact	bmmmmmmmmmmme
obproxyfound	bmmmmmmmmmme
og.header	beXbmmmme
ogg_iformat	bmeXbmmmmme
oldMsgId	bmebmebe
oldPosOnCurrentLine	bmebmebebmmmmmebmme
oldTrashNameUtf7	bmebmmmebmmebmes
oldportal.objectbuilder.document.cpp.editors.ClassMethodPanel	bmmmmmmmeXbmmmmmmmmmmmeXbmmmmmmeXbmeXbmmmmmeXbmmmebmmmmebmmme
omodes	bmmmme
one_fn	bmeXbe
opArguments	bebmmmmmmme
opLocalClock	bebmmmebmmme
opcode_function_new	bmmmmeXbmmmmmmeXbme
openb	bmmme
openwfe.org.net	bmmmmmeXbmeXbme
opt_BinaryDER	bmeXbmmmmebme
ordre.forcePropulseurArriere	bmmmeXbmmmebmmmmmmmmebmmmmme
oreq	bmme
orfs	bmme
org.amberarcher.os	bmeXbmmmmmmmmmeXbe
org.apache.poi.hssf.usermodel.TestCellStyle	bmeXbmmmmeXbmeXbmmeXbmmmmmmmeXbmmebmmebmmme
org.apache.slide.common.ServiceAccessException	bmeXbmmmmeXbmmmeXbmmmmeXbmmmmmebmmmmebmmmmmmme
org.apache.tools.ant.taskdefs.condition.Http	bmeXbmmmmeXbmmmeXbmeXbmmmmmmeXbmmmmmmmeXbmme
org.apache.turbine.flux.modules.actions.group	bmeXbmmmmeXbmmmmmeXbmmeXbmmmmmeXbmmmmmeXbmmme
org.bouncycastle.asn1.DERBoolean	bmeXbmmmmmmmmmmeXbmesXbmmmmmmmme
org.bouncycastle.crypto.engines.NullEngine	bmeXbmmmmmmmmmmeXbmmmmeXbmmmmmeXbmmebmmmme
org.bouncycastle.jce.cert.PKIXCertPathValidatorResult	bmeXbmmmmmmmmmmeXbmeXbmmeXbmmmmmmebmmebmmmmmmmebmmmme
org.centricware.storage.controller.guide.MenuController	bmeXbmmmmmmmmmeXbmmmmmeXbmmmmmmmmeXbmmmeXbmmebmmmmmmmme
org.columba.calendar.config.api.ICalendarList	bmeXbmmmmmeXbmmmmmmeXbmmmmeXbmeXbmmmmmmmebmme
org.dancres.blitz.remote.debug	bmeXbmmmmmeXbmmmeXbmmmmeXbmmme
org.dellroad.jc.cgen.analysis	bmeXbmmmmmmeXbeXbmmeXbmmmmmme
org.eclipse.jdt.core.IParent	bmeXbmmmmmeXbmeXbmmeXbmmmmme
org.emulinker.kaillera.pico	bmeXbmmmmmmmeXbmmmmmmeXbmme
org.htmlencoder.factory	bmeXbmmmmmmmmmeXbmmmmme
org.hyperic.hq.auth	bmeXbmmmmmeXbeXbmme
org.imemex.componentmappings.content.fsreplica	bmeXbmmmmeXbmmmmmmmmmmmmmmmeXbmmmmmeXbmmmmmmme
org.jamocha.gui.tab.FunctionsPanel	bmeXbmmmmmeXbmeXbmeXbmmmmmmmebmmme
org.jboss.virtual.plugins.vfs.helpers.SuffixesExcludeFilter	bmeXbmmmeXbmmmmmeXbmmmmmeXbmeXbmmmmmeXbmmmmmmebmmmmmebmmmme
org.jfree.util.SortOrder	bmeXbmmmeXbmmeXbmmebmmme
org.jruby.lexer.yacc.SourcePosition	bmeXbmmmeXbmmmeXbmmeXbmmmmebmmmmmme
org.jsecurity.context.factory.SecurityContextFactory	bmeXbmmmmmmmeXbmmmmmeXbmmmmmeXbmmmmmmebmmmmmebmmmmme
org.jvnet.jaxb.reflection.model.runtime.RuntimeTypeInfoSet	bmeXbmmmeXbmmeXbmmmmmmmmeXbmmmeXbmmmmmeXbmmmmmebmmebmmebme
org.ksmsa.richDoc.bibliography.types.BibType	bmeXbmmmeXbmmebmeXbmmmmmmmmmmeXbmmmeXbmebmme
org.mimosa.www.TechXMLV3_1.mim_5001_05.CharYN	bmeXbmmmmeXbmeXbmmebmmesXsXbmeXbmmeXbeXbmmebe
org.opengroupware.jogi.connect.Connection	bmeXbmmmmmmmmmmmeXbmmeXbmmmmmeXbmmmmmmmme
org.ourgrid.gridmachine.exception.UnableToExecuteException	bmeXbmmmmmeXbmmmmmmmmmeXbmmmmmmmeXbmmmmebebmmmmmebmmmmmmme
org.outerj.daisy.doctaskrunner.clientimpl	bmeXbmmmmeXbmmmeXbmmmmmmmmmmmeXbmmmmmmmme
org.pi4soa.designer.types.figures.SimpleTypeFigure	bmeXbesbmeXbmmmmmmeXbmmmeXbmmmmmeXbmmmmebmmebmmmme
org.pi4soa.service.DefaultIdentity	bmeXbesbmeXbmmmmmeXbmmmmmebmmmmmme
org.schmant.report.StdoutReportFactory	bmeXbmmmmmeXbmmmmeXbmmmmebmmmmebmmmmme
org.springframework.web.context.support.ServletContextResourceLoader	bmeXbmmmmmmmmmmmmmeXbmeXbmmmmmeXbmmmmmeXbmmmmmebmmmmmebmmmmmmebmmmme
org.touchupweb.system.UpdaterLauncher	bmeXbmmmmmmmmeXbmmmmeXbmmmmmebmmmmmme
org.umber.bellows.IDatumTransformer	bmeXbmmmeXbmmmmmeXbmmmmebmmmmmmmmme
org.xmlcrawler.iquery.QueryStructure	bmeXbmmmmmmmmeXbmmmmeXbmmmebmmmmmmme
orgLineColor	bmebmmebmmme
origArtOId	bmmebmebme
orig_to	bmmeXbe
originalVartype	bmmmmmmebmmmmme
os2.usWidthClass	besXbebmmmebmmme
os_file_closedir	beXbmmeXbmmmmmme
osmsDvAlgorithmManager	bmmebebmmmmmmmebmmmmme
other_expr	bmmmeXbmme
outBuf.mBuf_Fill	bmebmeXsbmeXbmme
outIfaceFuncImpl	bmebmmmebmmebmme
out_isatty	bmeXbmmmme
out_left_diff	bmeXbmmeXbmme
outcur	bmmmme
outpos	bmmmme
outputOrgs	bmmmmebmme
ovalrect_node	bmmmmmmeXbmme
p2absln	ssbmmme
pIDispParent	sbmmmebmmmme
pOdDescrProperty	sbebmmmebmmmmmme
p_cmdNumber	sXbmebmmmme
pac_io_krb_attrs	bmeXbeXbmeXbmmme
pango_coverage_new	bmmmeXbmmmmmmeXbme
paper_width_in_twips	bmmmeXbmmmeXbeXbmmme
param.res_length	bmmmeXbmeXbmmmme
param.tmpdir	bmmmeXbmmmme
paramOrdinal	bmmmebmmmmme
paramParseFile	bmmmebmmmebmme
param_usage	bmmmeXbmmme
params.CalGrayProfile	bmmmmeXbmebmmebmmmmme
params.def	bmmmmeXbme
parseDefLine	bmmmebmebmme
parseDocumentElement	bmmmebmmmmmmebmmmmme
parseIntArrayToString	bmmmebmebmmmebebmmmme
partOutLen	bmmebmebme
passoL	bmmmes
passwordTemplate	bmmmmmmebmmmmmme
pcmret	bmmmme
pcr	bme
pdf14_mark_procs	bmebeXbmmeXbmmme
pdf_font_descriptor_values_t	bmeXbmmeXbmmmmmmmmeXbmmmmeXs
pharerouge.utils.InterruptableInputStream	bmmmmmmmmeXbmmmeXbmmmmmmmmmmmebmmmebmmmme
phex.xml.sax.DElement	bmmeXbmeXbmeXbmmmmmme
pixbufLock	bmmmmebmme
pn_max	beXbme
pnlEsEcl_btnOutDir.setEnabled	bmebebmeXbmebmebmeXbmebmmmmme
portTypeNamespace	bmmebmmebmmmmmmme
prFileNo	bebmmebe
pr_previous	beXbmmmmmme
prec_sym_name.value	bmmeXbmeXbmmeXbmmme
pred_ctime	bmmeXbmmme
predict_16x16_dc_top	bmmmmmeXbesbeXbeXbme
prefColorTree	bmmebmmmebmme
pref_saveArgs	bmmeXbmmebmme
prefsData.verbose	bmmmebmmeXbmmmmme
presentationFacade	bmmmmmmmmmmebmmmme
prevDescent	bmmebmmmmme
prevGcpConnect	bmmebmebmmmmme
prev_pos	bmmeXbme
previous_ch	bmmmmmmeXbe
primary_gid	bmmmmmeXbme
printDROP_TRIG_CONF	bmmmebmmeXbmmeXbmme
printPreBlockExpression	bmmmebmebmmmebmmmmmmmme
print_ident_comments	bmmmeXbmmmeXbmmmmmme
print_unexp	bmmmeXbmmme
printdir	bmmmmmme
process_nmb_request	bmmmmmeXbmeXbmmmmme
procnames_start_line	bmmmmmmmeXbmmmeXbmme
productUPDATESQL	bmmmmmebmmmmmmme
profDebutPlage	bmmebmmmebmmme
psFGList	bebmmmme
psf_get_filelen_fd	bmeXbmeXbmmmmmeXbe
psname	bmmmme
pstoreDir	bmmmmebme
ptr_passwd	bmeXbmmmme
publicationUrl	bmmmmmmmmmebme
pusWrappedKeyLen	bmebmmmmmebmebme
pwce	bmme
q1_numfaces	ssXbmmmmmme
qe.last_pos_said	beXbmmeXbmeXbmme
qglMapGrid2f	bmebmebmmess
qglTexGenfv	bmebmebmmme
qpix_avg	bmmeXbme
query_md_blob_data_req	bmmmeXbeXbmmeXbmmeXbme
questKill	bmmmebmme
quicktime_edts_t	bmmmmmmmeXbmmeXs
quicktime_flush_vcodec	bmmmmmmmeXbmmmeXbmmmme
rCombo.bottom	sbmmmeXbmmmme
randHash	bmmebmme
randomNumberGen	bmmmmebmmmmebme
rcchk_	bmmme
rcverHostName	bmmmebmmebmme
readExecSrNewMbyte	bmmebmmebebmebmmme
readVCM	bmmebme
reads_colormodel	bmmmeXbmmmmmmmme
realURI	bmmebme
recordingfilename	bmmmmmmmmmmmmmmme
recursiveNodeTraversal	bmmmmmmmebmmebmmmmmmme
recv_max_parsed_page_no	bmmeXbmeXbmmmmeXbmmeXbe
redirectParent	bmmmmmmebmmmme
redirectorType	bmmmmmmmmebmme
refHdr	bmebme
refQueueInfo	bmebmmmebmme
reflowReasonString	bmmmmebmmmmebmmmme
refreshFavouritesList	bmmmmmebmmmmmmmmebmme
reg.i_key_boost	bmeXsXbmeXbmmme
reg_set_table_size	bmeXbmeXbmmmeXbmme
register_agent	bmmmmmmeXbmmme
regmove_time	bmmmmmeXbmme
reloadreg	bmmmmmmme
remote_playlist_delete	bmmmmeXbmmmmmmeXbmmmme
removeBotsMenuInfo.up.width	bmmmmebmmebmmebmmeXbeXbmmme
resolution_opt	bmmmmmmmmeXbme
ret_sub	bmeXbme
retco	bmmme
rev_increment	bmeXbmmmmmmme
rgTop	bebme
rgb4	bmes
rhs.mStartPageNum	bmeXsbmmmebmmebme
rightFreedom	bmmmebmmmmme
rightPos	bmmmebme
rl_editing_mode	beXbmmmmmeXbmme
roid	bmme
rowCopyLen	bmebmmebme
row_upd_rec_sys_fields_in_recovery	bmeXbmeXbmeXbmeXbmmmmeXbeXbmmmmmme
rstrmbuf	bmmmmmme
rtlname	bmmmmme
run_eol_code_value	bmeXbmeXbmmeXbmmme
runiqueId	bmmmmmebe
rw_case	beXbmme
s3mrtgspeed	ssbmmmmmmme
sBeginLineString	sbmmmebmmebmmmme
sDB_COLUMN	sbeXbmmmme
sHTMLTagUnicodeName_img	sbmmmmmebmmmmmebmmeXbme
sOS_DriveDirectory	sbeXbmmmebmmmmmmme
sUint16Val	sbmmebebme
s_options.sound.style	sXbmmmmmeXbmmmeXbmmme
s_playersettings.banner.generic.y	sXbmmmmmmmmmmmmeXbmmmmeXbmmmmmeXs
s_signup.password.generic.type	sXbmmmmeXbmmmmmmeXbmmmmmeXbmme
saga.inout.creation.CreationHandlerImpl	bmmeXbmmmeXbmmmmmmeXbmmmmmmebmmmmmebmme
sampfmt	bmmmmme
sampy	bmmme
sandcx	bmmmme
saveConfigActionPerformed	bmmebmmmmebmmmmebmmmmmmme
saveXTFRInfo	bmmebmmmmmme
sball	bmmme
scalar12_float32_3DNow	bmmmmebeXbmmmebeXsbmme
scanKeyinfoFlag	bmmebmmmmmebmme
scanLocalref	bmmebmmmmmme
scattoAllaRisposta	bmmmmebmmebmmmmmme
sd.signatureAlgorithm	beXbmmmmmmmebmmmmmmme
searchInfo1.hFileInfo.ioFlFndrInfo.fdLocation.h	bmmmmebmmesXsbmmebmmeXbebebmmebmmeXbebmmmmmmeXs
sec_desc_size	bmeXbmmeXbmme
sec_pkcs12_destroy_certificate_list	bmeXbmmebeXbmmmmmeXbmmmmmmmmmeXbmme
secmodSlotDataStr	bmmmmebmmebmmebme
secrets_store_ldap_pw	bmmmmmeXbmmmeXbmmeXbe
sect.sct_loyal	bmmeXbmeXbmmme
sect_amt	bmmeXbme
sendNdbSttor	bmmebmebmmme
servermajorversion	bmmmmmmmmmmmmmmmme
serverport	bmmmmmmmme
serviceNameQName	bmmmmmebmmebmmme
service_deregister	bmmmmmeXbmmmmmmmme
setActiveTarget	bmebmmmmebmmmme
setAffichageSide	bmebmmmmmmmebmme
setAfficheDebFin	bmebmmmmmebmebme
setDisplayPicutre	bmebmmmmmebmmmmme
setDontBalanceTextColumns	bmebmmebmmmmmebmmebmmmmme
setGCtrl	bmebmmme
setImageResize	bmebmmmebmmmme
setInternalLoc	bmebmmmmmmebme
setMemberFirstIP	bmebmmmmebmmmebe
setPaginableFind	bmebmmmmmmmebmme
setRsrc_Name	bmebmmeXbmme
setRunAttributesCB	bmebmebmmmmmmmmebe
setTopLevelGroupCRID	bmebmebmmmebmmmebmme
setYAxisLabelsPos	bmebmmmebmmmmebme
set_io	bmeXbe
sfString.s	bebmmmmeXs
sfcadj	bmmmme
sfsbhome	bmmmmmme
sha_inner	bmeXbmmme
shared_memory_pos	bmmmmeXbmmmmeXbme
ship.shp_y	bmmeXbmeXs
should	bmmmme
si_DoDialogIfPrefIsOff	beXbebmmmmebebmmebebme
sig_table_nelts	bmeXbmmmeXbmmme
sincos_bf	bmmmmeXbe
size2.cx	bmmesXbe
skel_sys_acl_get_perm	bmmeXbmeXbmeXbmeXbmme
skip_bottom	bmmeXbmmmme
slin_g723_ex	bmmeXsbmeXbe
smbw_shared_fd	bmmeXbmmmmeXbe
smilehouse.opensyncro.pipes.component.DestinationIF	bmmmmmmmmeXbmmmmmmmmeXbmmmeXbmmmmmmmeXbmmmmmmmmmebe
sndCall.addr.maxlen	bmebmmeXbmmeXbmmmme
snd_ctl_elem_info_get_numid	bmeXbmeXbmmeXbmmeXbmeXbmmme
snd_interval_t	bmeXbmmmmmmeXs
snd_mixer_selem_set_capture_volume_range	bmeXbmmmeXbmmmeXbmeXbmmmmmeXbmmmmeXbmmme
snd_pcm_route_ttable_entry_t	bmeXbmeXbmmmeXbmmmmeXbmmmeXs
snd_seq_queue_timer_t	bmeXbmeXbmmmeXbmmmeXs
snlimit	bmmmmme
sock_info.remote	bmmeXbmmeXbmmmme
spDocHostUIHandler	bebmebmmebmmmmmmme
spawn_init	bmmmeXbmme
splitToIntArray	bmmmebebmebmmme
sqlOrderByClause	bmebmmmebebmmmme
srcPix	bmebme
ss.g_idx	beXsXbme
ssl_InitGather	bmeXbmmebmmmme
ssl_socket_sendv	bmeXbmmmmeXbmmme
startPoint.y	bmmmebmmmeXs
startSimulationUpdate	bmmmebmmmmmmmmebmmmme
stgmedData	bmmmmebmme
stockHeight	bmmmebmmmme
stopMbyte	bmmebmmme
strIDError	bmebmmmmme
strPoint	bmebmmme
str_AboutNMinutes	bmeXbmmmebmmmmmme
stream_hc_state	bmmmmeXbeXbmmme
styleSheetFactory	bmmmebmmmebmmmmme
svr.peer	bmeXbmme
swf_write_trailer	bmeXbmmmeXbmmmmme
swingActions.LAF	bmmmebmmmmmeXbme
swpOK	bmebe
synced	bmmmme
sys_trust_routine_creators	bmeXbmmmeXbmmmmmeXbmmmmmme
tabSuperProfiles	bmebmmmebmmmmmme
tc_ett	beXbme
tc_log	beXbme
tcl_LogGet	bmeXbmebme
tcp_print_conn	bmeXbmmmeXbmme
teardownReports.toArray	bmmmmmmebmmmmmeXbebmmme
tech_log_base	bmmeXbmeXbmme
tensor_obounds	bmmmmeXbmmmmme
term_mm	bmmeXbe
terraindata.headerinfo.MinimumAltitude	bmmmmmmmmmeXbmmmmmmmmeXbmmmmmebmmmmmme
testAverageDistancesOnFfiniteDiameterGraph	bmmebmmmmmebmmmmmmmebebmmmmmebmmmmmmebmmme
testEnterJTableHeaderDragAndLeaveByPercentage	bmmebmmmebmmmmebmmmmebmmebmebmmmebebmmmmmmmme
testHeightOffsetWGS72	bmmebmmmmebmmmmebmebe
testIsAnnotation	bmmebebmmmmmmmme
testLoadClassesFromClasspathSorted	bmmebmmebmmmmmebmmebmmmmmmmebmmmme
testMetaDataDOM	bmmebmmebmmebme
testRmiProxyFactoryBeanWithConnectIOException	bmmebmebmmmebmmmmmebmmebmmebmmmmmebmmmmmmmmme
testSJISEncoder	bmmebmmmmmmmmme
testSimple7b	bmmebmmmmess
testWriteFloat	bmmebmmmebmmme
tests.basic.ResultSetTypesTests.suite	bmmmeXbmmmeXbmmmmebmebmmmebmmmeXbmmme
textnode	bmmmmmme
textoSuperior	bmmmebmmmmmme
tfact	bmmme
tftpfolderField	bmmmmmmmmebmmme
tgeLocked	bmebmmmme
tgseElementptr	bmmebmmmmmmmme
that.global_block_size	bmmeXbmmmmeXbmmmeXbmme
theDeathDB.updateFidByPtid	bmebmmmebeXbmmmmebmebebmme
theImpl	bmebmme
theend	bmmmme
theframed	bmmmmmmme
themepackLabel	bmmmmmmmebmmme
this.GL_ARB_point_parameters	bmmeXbeXbmeXbmmmeXbmmmmmmmme
this.allterms_hash	bmmeXbmmmmmmeXbmme
this.cbSize.setSelectedIndex	bmmeXbebmmeXbmebmmmmmmebmmme
this.checkboxArticle	bmmeXbmmmmmmebmmmmme
this.cmd_id	bmmeXbmeXbe
this.docLangId	bmmeXbmebmmebe
this.gcb	bmmeXbme
this.loginExisted	bmmeXbmmmebmmmmme
this.maxNumberOfGameConnections	bmmeXbmebmmmmebebmmebmmmmmmmmme
this.metaTable	bmmeXbmmebmmme
this.referencedObjectTimestampMap	bmmeXbmmmmmmmmebmmmmebmmmmmmmebme
this.txtPatientNumberFocusLost	bmmeXbmebmmmmmebmmmmebmmmebmme
this.wildcardexclude	bmmeXbmmmmmmmmmmmmme
tib_ptib2	bmeXbmmes
timSizeH	bmebmmes
timestarted	bmmmmmmmmme
timezoneAddr	bmmmmmmebmme
tmp.m_variant	bmeXsXbmmmmme
tmpIIData.endIndex	bmebmmmmeXbmebmmme
tmpLevelStep	bmebmmmebmme
tmpQ.z	bmesXs
tmpchar	bmmmmme
tmpu	bmme
tnd.szTip	bmeXbebme
toAbortHandlingLab	bebmmmebmmmmmmebme
todayFlexidate	bmmmebmmmmmmme
toggleConditionalBreakpoint	bmmmmebmmmmmmmmmebmmmmmmmme
toggleMinPieceSpacing	bmmmmebmebmmmebmmmmme
tok_info.hardwareVersion.minor	bmeXbmmeXbmmmmmmebmmmmmeXbmmme
tooltipEl	bmmmmmebe
tpltObj.getName	bmmebmeXbmebmme
tr_localaddr	beXbmmmmmmme
track_num	bmmmeXbme
transfer_RGB_FLOAT_to_YUV444P	bmmmmmmeXbmeXbmmmeXbeXbmebmes
treservations	bmmmmmmmmmmme
trigname	bmmmmmme
trlRelCon	bmebmebme
trx_undo_seg_create	bmeXbmmeXbmeXbmmmme
try_SetCought	bmeXbmebmmmme
tsscContainerptr	bmmebmmmmmmmmmme
tstfillp	bmmmmmme
ttx	bme
tupleOfTVars	bmmmebebmmme
tw.sphere	beXbmmmme
twosided	bmmmmmme
txMode	bebmme
txXSLTProcessor	bebmmmmmmmmmmme
txtMisc	bmebmme
u.A_WhichIO.ut_in_out_put_t_1	sXsXbmmmebeXbeXbeXbmeXbmeXsXs
uClientIP	sbmmmmebe
ubody	bmmme
uf_space_prespace	beXbmmmeXbmmmmmme
ui64TotFileSize	bebebmebmmebmme
uiThread	bebmmmme
ui_setOrientProc	beXbmebmmmmebmme
ui_teamName	beXbmmebmme
ulScreenY	bebmmmmes
undirected	bmmmmmmmme
unregisterBean	bmmmmmmmmebmme
unsetFileName	bmmmebmmebmme
updatable_view	bmmmmmmmeXbmme
updateAllDiffBackgrounds	bmmmmebmebmmebmmmmmmmmme
usage_getdata	bmmmeXbmmmmme
use_aic	bmeXbme
usemap	bmmmme
userClickText	bmmebmmmebmme
usr.isBot	bmeXbebme
usrResults	bmebmmmmme
ut_stats_tag_t	beXbmmmeXbmeXs
uval.dv	bmmeXbe
v4l2_parm.parm.capture.capturemode	ssssXbmmeXbmmeXbmmmmmeXbmmmmmmmmme
va.persistent	beXbmmmmmmmme
validItem	bmmmebmme
validSValuesAndGenes	bmmmebmmmmmebmebmmme
value_top_sizeof	bmmmeXbmeXbmmmme
var_defend	bmeXbmmmme
variables.max_length_for_sort_data	bmmmmmmmeXbmeXbmmmmeXbmeXbmmeXbmme
varid	bmmme
vars_need_expansion	bmmeXbmmeXbmmmmmmme
vdrad	bmmme
vec_transpose	bmeXbmmmmmmme
versionend	bmmmmmmmme
viewx	bmmme
vlp_job	bmeXbme
vmprintfes	bmmmmmmmme
vmx.ssp	bmeXbme
vpage_buffer_length	bmmmeXbmmmmeXbmmmme
vpix.x	bmmeXs
vqgen	bmmme
vstr	bmme
vui.i_num_reorder_frames	bmeXsXbmeXbmmmmmeXbmmmme
wcspbrk	bmmmmme
wds	bme
wf.cbSize	beXbebmme
wfDetailString	bebmmmmebmmmme
widgets.fpfToggle	bmmmmmeXbmebmmmme
wins_srv_count	bmmeXbmeXbmmme
wndUnderMouse	bmebmmmebmmme
worker.billing_last_name	bmmmmeXbmmmmmeXbmmeXbmme
wqueue	bmmmme
wrappedStmt.executeUpdate	bmmmmmebmmeXbmmmmmebmmmme
writeCompartment	bmmmebmmmmmmmmme
writeCustomHTML	bmmmebmmmmebmme
wtype	bmmme
x264_cabac_t	sbmeXbmmmeXs
xGetJobStaus	sbmebmebmmme
xcolor.flags	bmmmmeXbmmme
xgetColumnWidth	bmmebmmmmebmmme
xpc_proto_proto	bmeXbmmmeXbmmme
xtVersion	bebmmmmme
xtest	bmmme
yyz_flex_debug	bmeXbmmeXbmmme
~AggregateTransaction	Xbmmmmmmmebmmmmmmmmme
~CodeFragment	Xbmmebmmmmmme
~RobotSink	Xbmmmebmme
~txSyncCompileObserver	Xbebmmebmmmmmebmmmmmme
